is_installed,station_id,num_docks_available,num_bikes_available,num_ebikes_available,is_renting,num_docks_disabled,is_returning,num_bikes_disabled,num_scooters_available,num_scooters_unavailable,timestamp,n_classic,n_electric,n_scooters
0,1958859639339458778,0,0,0,0,0,0,0,,,01/01/1970 06:00 PM,0,0,0
1,1943244109954931024,5,1,0,1,0,1,0,8.0,1.0,06/18/2024 08:09 AM,1,0,0
1,a3a72012-a135-11e9-9cda-0a87ae2ba916,7,1,0,1,0,1,3,0.0,0.0,06/18/2024 08:11 AM,1,0,0
1,1929905600854819414,0,12,10,1,0,1,2,1.0,0.0,06/18/2024 08:11 AM,2,10,0
1,4843d153-c725-4230-a4c7-402da6a62143,0,4,3,1,8,1,1,3.0,0.0,06/18/2024 08:11 AM,1,3,0
1,a3ad8072-a135-11e9-9cda-0a87ae2ba916,22,7,4,1,0,1,2,0.0,0.0,06/18/2024 08:11 AM,3,4,0
1,a3acea44-a135-11e9-9cda-0a87ae2ba916,5,5,0,1,0,1,1,0.0,0.0,06/18/2024 08:11 AM,5,0,0
1,759171ce-f355-4740-948d-e14bb8f7dc0e,7,8,3,1,0,1,0,0.0,0.0,06/18/2024 08:11 AM,5,3,0
1,1799277526470631980,3,10,3,1,0,1,0,2.0,0.0,06/18/2024 08:11 AM,7,3,0
1,a3a9f76a-a135-11e9-9cda-0a87ae2ba916,1,11,2,1,0,1,2,1.0,0.0,06/18/2024 08:11 AM,9,2,0
1,a3af2737-a135-11e9-9cda-0a87ae2ba916,1,14,11,1,0,1,0,0.0,0.0,06/18/2024 08:11 AM,3,11,0
1,a3b4399a-a135-11e9-9cda-0a87ae2ba916,7,2,0,1,0,1,1,4.0,1.0,06/18/2024 08:11 AM,2,0,0
1,a3a5d3bb-a135-11e9-9cda-0a87ae2ba916,9,1,0,1,0,1,1,4.0,0.0,06/18/2024 08:11 AM,1,0,4
1,a3b29fae-a135-11e9-9cda-0a87ae2ba916,7,4,0,1,0,1,0,0.0,0.0,06/18/2024 08:11 AM,4,0,0
1,a3b2be3a-a135-11e9-9cda-0a87ae2ba916,2,9,5,1,0,1,0,0.0,0.0,06/18/2024 08:11 AM,4,5,0
1,1942117929887056608,3,11,8,1,0,1,1,0.0,0.0,06/18/2024 08:12 AM,3,8,0
1,a3b2862e-a135-11e9-9cda-0a87ae2ba916,6,4,0,1,0,1,1,0.0,0.0,06/18/2024 08:12 AM,4,0,0
1,a3a5f5e6-a135-11e9-9cda-0a87ae2ba916,7,4,2,1,0,1,0,0.0,0.0,06/18/2024 08:12 AM,2,2,0
1,a3a3b202-a135-11e9-9cda-0a87ae2ba916,2,11,0,1,0,1,1,0.0,1.0,06/18/2024 08:12 AM,11,0,0
1,a3b22d3d-a135-11e9-9cda-0a87ae2ba916,2,9,1,1,0,1,0,0.0,0.0,06/18/2024 08:12 AM,8,1,0
1,a3b1d532-a135-11e9-9cda-0a87ae2ba916,4,6,3,1,0,1,1,0.0,0.0,06/18/2024 08:12 AM,3,3,0
1,a3a8999a-a135-11e9-9cda-0a87ae2ba916,22,3,2,1,0,1,6,0.0,0.0,06/18/2024 08:12 AM,1,2,0
1,a3ab86b6-a135-11e9-9cda-0a87ae2ba916,6,13,3,1,0,1,1,2.0,0.0,06/18/2024 08:12 AM,10,3,2
1,a3a8855c-a135-11e9-9cda-0a87ae2ba916,4,15,1,1,0,1,4,0.0,0.0,06/18/2024 08:12 AM,14,1,0
1,1955905507044284968,6,9,9,1,0,1,0,0.0,0.0,06/18/2024 08:12 AM,0,9,0
1,a3af2c5f-a135-11e9-9cda-0a87ae2ba916,9,9,4,1,0,1,1,0.0,0.0,06/18/2024 08:12 AM,5,4,0
1,792ceba0-564f-4a2c-bcb5-90da781ffeef,13,1,1,1,0,1,1,0.0,0.0,06/18/2024 08:12 AM,0,1,0
1,a3b477ac-a135-11e9-9cda-0a87ae2ba916,1,13,7,1,0,1,0,1.0,0.0,06/18/2024 08:12 AM,6,7,0
1,a3a62fc9-a135-11e9-9cda-0a87ae2ba916,3,7,0,1,0,1,4,0.0,1.0,06/18/2024 08:12 AM,7,0,0
1,a3a48d5c-a135-11e9-9cda-0a87ae2ba916,3,16,2,1,0,1,4,0.0,0.0,06/18/2024 08:12 AM,14,2,0
1,a3ac7444-a135-11e9-9cda-0a87ae2ba916,2,5,0,1,0,1,3,5.0,0.0,06/18/2024 08:12 AM,5,0,5
1,a3b222fc-a135-11e9-9cda-0a87ae2ba916,2,9,3,1,0,1,0,0.0,0.0,06/18/2024 08:12 AM,6,3,0
1,a3a3a282-a135-11e9-9cda-0a87ae2ba916,9,26,5,1,0,1,0,0.0,0.0,06/18/2024 08:12 AM,21,5,0
1,a3aaa68b-a135-11e9-9cda-0a87ae2ba916,4,10,1,1,0,1,3,2.0,0.0,06/18/2024 08:12 AM,9,1,0
1,a3a528d0-a135-11e9-9cda-0a87ae2ba916,8,1,0,1,0,1,2,0.0,0.0,06/18/2024 08:12 AM,1,0,0
1,da9e6779-5056-4d45-bae3-9dc325ed2807,6,5,0,1,0,1,0,0.0,0.0,06/18/2024 08:12 AM,5,0,0
1,a3aa8ca0-a135-11e9-9cda-0a87ae2ba916,11,1,0,1,0,1,3,0.0,0.0,06/18/2024 08:12 AM,1,0,0
1,a3ac9d43-a135-11e9-9cda-0a87ae2ba916,8,14,0,1,0,1,0,1.0,0.0,06/18/2024 08:12 AM,14,0,0
1,1936553212713581016,12,3,0,1,0,1,0,1.0,0.0,06/18/2024 08:12 AM,3,0,0
1,a3b48c07-a135-11e9-9cda-0a87ae2ba916,9,6,3,1,0,1,3,1.0,0.0,06/18/2024 08:12 AM,3,3,0
1,a3a62aad-a135-11e9-9cda-0a87ae2ba916,2,16,4,1,0,1,1,0.0,0.0,06/18/2024 08:13 AM,12,4,0
1,a3b00b3a-a135-11e9-9cda-0a87ae2ba916,4,11,4,1,0,1,0,0.0,0.0,06/18/2024 08:12 AM,7,4,0
1,a3a9b1d7-a135-11e9-9cda-0a87ae2ba916,4,9,0,1,0,1,2,0.0,0.0,06/18/2024 08:12 AM,9,0,0
1,a3a75d8a-a135-11e9-9cda-0a87ae2ba916,10,6,0,1,0,1,4,0.0,0.0,06/18/2024 08:12 AM,6,0,0
1,a3a497b6-a135-11e9-9cda-0a87ae2ba916,18,1,0,1,0,1,0,0.0,0.0,06/18/2024 08:12 AM,1,0,0
1,a3a614ad-a135-11e9-9cda-0a87ae2ba916,5,23,7,1,0,1,1,2.0,0.0,06/18/2024 08:12 AM,16,7,2
1,1879436840905128284,9,3,0,1,0,1,3,0.0,0.0,06/18/2024 08:12 AM,3,0,0
1,a3aa0bb7-a135-11e9-9cda-0a87ae2ba916,7,7,1,1,0,1,1,0.0,0.0,06/18/2024 08:12 AM,6,1,0
1,a3acb1de-a135-11e9-9cda-0a87ae2ba916,4,5,4,1,0,1,2,0.0,0.0,06/18/2024 08:12 AM,1,4,0
1,a3b11480-a135-11e9-9cda-0a87ae2ba916,4,7,2,1,0,1,0,0.0,0.0,06/18/2024 08:12 AM,5,2,0
1,a3a5700b-a135-11e9-9cda-0a87ae2ba916,0,20,0,1,0,1,5,1.0,0.0,06/18/2024 08:11 AM,20,0,1
1,1929538112769137066,10,2,0,1,0,1,3,0.0,0.0,06/18/2024 08:11 AM,2,0,0
1,a3af9a83-a135-11e9-9cda-0a87ae2ba916,6,8,0,1,0,1,1,0.0,0.0,06/18/2024 08:11 AM,8,0,0
1,a3b10a40-a135-11e9-9cda-0a87ae2ba916,8,3,1,1,0,1,0,0.0,0.0,06/18/2024 08:11 AM,2,1,0
1,a3aa35a4-a135-11e9-9cda-0a87ae2ba916,8,15,4,1,0,1,2,6.0,0.0,06/18/2024 08:11 AM,11,4,0
1,a3a965b2-a135-11e9-9cda-0a87ae2ba916,8,7,5,1,0,1,0,0.0,0.0,06/18/2024 08:11 AM,2,5,0
1,a3a76cb6-a135-11e9-9cda-0a87ae2ba916,11,2,0,1,0,1,2,0.0,0.0,06/18/2024 08:11 AM,2,0,0
1,a3ac35ed-a135-11e9-9cda-0a87ae2ba916,2,7,1,1,0,1,0,1.0,0.0,06/18/2024 08:11 AM,6,1,0
1,a3a3b731-a135-11e9-9cda-0a87ae2ba916,7,8,0,1,0,1,4,1.0,2.0,06/18/2024 08:11 AM,8,0,1
1,430d5876-c44d-446e-ac53-065da9fb9c17,0,5,1,1,1,1,4,0.0,0.0,06/18/2024 08:11 AM,4,1,0
1,a3b1fa1c-a135-11e9-9cda-0a87ae2ba916,6,4,0,1,0,1,1,0.0,0.0,06/18/2024 08:11 AM,4,0,0
1,a3b23cb8-a135-11e9-9cda-0a87ae2ba916,4,6,2,1,0,1,1,0.0,0.0,06/18/2024 08:11 AM,4,2,0
1,a3b13836-a135-11e9-9cda-0a87ae2ba916,8,1,1,1,0,1,2,0.0,0.0,06/18/2024 08:11 AM,0,1,0
1,a3a3e67b-a135-11e9-9cda-0a87ae2ba916,27,1,0,1,0,1,2,0.0,0.0,06/18/2024 08:11 AM,1,0,0
1,a3a547b8-a135-11e9-9cda-0a87ae2ba916,4,11,3,1,0,1,0,0.0,0.0,06/18/2024 08:11 AM,8,3,0
1,e63300bd-4ca3-4255-adfd-522289d68b8a,8,4,1,1,0,1,3,0.0,0.0,06/18/2024 08:11 AM,3,1,0
1,a3b1c47b-a135-11e9-9cda-0a87ae2ba916,6,4,2,1,0,1,1,0.0,0.0,06/18/2024 08:11 AM,2,2,0
1,a21de1a5-f5bc-4b50-8a13-aa28b7dcfa95,13,0,0,1,0,1,2,0.0,0.0,06/18/2024 08:12 AM,0,0,0
1,a3ad13e4-a135-11e9-9cda-0a87ae2ba916,6,4,0,1,0,1,1,0.0,0.0,06/18/2024 08:12 AM,4,0,0
1,a3afbe2e-a135-11e9-9cda-0a87ae2ba916,4,9,1,1,0,1,2,0.0,0.0,06/18/2024 08:12 AM,8,1,0
1,ff21c158-de98-46c6-9ef7-7082bdb7c634,5,9,0,1,0,1,1,0.0,0.0,06/18/2024 08:12 AM,9,0,0
1,a3af52bc-a135-11e9-9cda-0a87ae2ba916,1,20,1,1,0,1,2,0.0,0.0,06/18/2024 08:12 AM,19,1,0
1,a3a99d47-a135-11e9-9cda-0a87ae2ba916,19,3,0,1,0,1,0,0.0,1.0,06/18/2024 08:12 AM,3,0,0
1,a3b148bf-a135-11e9-9cda-0a87ae2ba916,4,5,3,1,0,1,2,1.0,0.0,06/18/2024 08:12 AM,2,3,0
1,a3a6c38e-a135-11e9-9cda-0a87ae2ba916,13,4,0,1,0,1,0,1.0,0.0,06/18/2024 08:12 AM,4,0,0
1,a3ac3b03-a135-11e9-9cda-0a87ae2ba916,4,9,6,1,0,1,3,0.0,0.0,06/18/2024 08:12 AM,3,5,0
1,a3ac7e9a-a135-11e9-9cda-0a87ae2ba916,9,6,2,1,0,1,0,0.0,0.0,06/18/2024 08:12 AM,4,2,0
1,a3a97a01-a135-11e9-9cda-0a87ae2ba916,4,10,1,1,0,1,0,0.0,0.0,06/18/2024 08:12 AM,9,1,0
1,a3ad95a7-a135-11e9-9cda-0a87ae2ba916,0,10,1,1,0,1,5,0.0,0.0,06/18/2024 08:12 AM,9,1,0
1,90011328-f7bd-4b7b-8f95-8204a0b50f27,10,0,0,1,0,1,1,0.0,0.0,06/18/2024 08:12 AM,0,0,0
1,a3a565b1-a135-11e9-9cda-0a87ae2ba916,17,2,2,1,0,1,0,0.0,0.0,06/18/2024 08:12 AM,1,2,0
1,a3aabad8-a135-11e9-9cda-0a87ae2ba916,4,15,5,1,0,1,0,0.0,0.0,06/18/2024 08:12 AM,10,5,0
1,a3a8804b-a135-11e9-9cda-0a87ae2ba916,7,8,6,1,0,1,4,0.0,0.0,06/18/2024 08:12 AM,2,6,0
1,1928792940289520096,2,12,10,1,0,1,0,1.0,0.0,06/18/2024 08:12 AM,2,10,0
1,1942118582722085548,6,8,6,1,0,1,1,0.0,0.0,06/18/2024 08:12 AM,2,6,0
1,1943244520961310788,8,4,3,1,0,1,1,2.0,0.0,06/18/2024 08:12 AM,1,3,0
1,1929883678185797908,5,9,5,1,0,1,1,0.0,0.0,06/18/2024 08:12 AM,4,5,0
1,a3af8123-a135-11e9-9cda-0a87ae2ba916,10,4,1,1,0,1,1,1.0,0.0,06/18/2024 08:12 AM,3,1,0
1,1871992980799203880,10,4,0,1,0,1,1,0.0,0.0,06/18/2024 08:12 AM,4,0,0
1,a3acdae2-a135-11e9-9cda-0a87ae2ba916,5,4,2,1,0,1,2,0.0,0.0,06/18/2024 08:12 AM,2,2,0
1,a3a3f0c6-a135-11e9-9cda-0a87ae2ba916,1,5,1,1,0,1,8,0.0,0.0,06/18/2024 08:12 AM,4,1,0
1,a3b01a86-a135-11e9-9cda-0a87ae2ba916,11,3,3,1,0,1,0,0.0,1.0,06/18/2024 08:12 AM,0,3,0
1,a3b2905a-a135-11e9-9cda-0a87ae2ba916,5,6,1,1,0,1,0,0.0,0.0,06/18/2024 08:12 AM,5,1,0
1,1850866657089146912,2,12,3,1,0,1,1,4.0,0.0,06/18/2024 08:12 AM,9,3,0
1,a3afd7ab-a135-11e9-9cda-0a87ae2ba916,6,9,5,1,0,1,0,0.0,0.0,06/18/2024 08:12 AM,4,5,0
1,a3b2d7d9-a135-11e9-9cda-0a87ae2ba916,3,7,3,1,0,1,1,0.0,0.0,06/18/2024 08:12 AM,4,3,0
1,1936582560225114270,10,5,2,1,0,1,0,0.0,0.0,06/18/2024 08:12 AM,3,2,0
1,a3b47cbc-a135-11e9-9cda-0a87ae2ba916,2,9,3,1,0,1,0,4.0,0.0,06/18/2024 08:12 AM,6,3,4
1,a3a52df5-a135-11e9-9cda-0a87ae2ba916,17,6,2,1,0,1,0,0.0,0.0,06/18/2024 08:12 AM,4,2,0
1,1869054242749504212,8,7,1,1,0,1,0,0.0,0.0,06/18/2024 08:12 AM,6,1,0
1,a3b0fae6-a135-11e9-9cda-0a87ae2ba916,6,7,1,1,0,1,2,0.0,0.0,06/18/2024 08:12 AM,6,1,0
1,a3a83ba1-a135-11e9-9cda-0a87ae2ba916,7,12,2,1,0,1,0,0.0,0.0,06/18/2024 08:12 AM,10,2,0
1,1867616662773391950,3,12,3,1,0,1,0,0.0,0.0,06/18/2024 08:12 AM,9,3,0
1,a3a79adb-a135-11e9-9cda-0a87ae2ba916,15,12,3,1,0,1,0,0.0,0.0,06/18/2024 08:12 AM,9,3,0
1,a3a9c0f6-a135-11e9-9cda-0a87ae2ba916,5,2,1,1,0,1,0,4.0,0.0,06/18/2024 08:12 AM,1,1,4
1,a3addda0-a135-11e9-9cda-0a87ae2ba916,2,9,8,1,0,1,0,0.0,0.0,06/18/2024 08:12 AM,1,8,0
1,a3a41004-a135-11e9-9cda-0a87ae2ba916,4,8,1,1,0,1,1,2.0,0.0,06/18/2024 08:12 AM,7,1,0
1,a3af460f-a135-11e9-9cda-0a87ae2ba916,2,16,14,1,0,1,0,1.0,0.0,06/18/2024 08:12 AM,2,14,0
1,a3ad4d1b-a135-11e9-9cda-0a87ae2ba916,6,9,3,1,0,1,0,0.0,0.0,06/18/2024 08:12 AM,6,3,0
1,f0f9f5dc-3d3f-4a32-aa3e-b87566e44de9,9,6,2,1,0,1,0,0.0,0.0,06/18/2024 08:12 AM,4,2,0
1,a3ad2d57-a135-11e9-9cda-0a87ae2ba916,2,6,1,1,0,1,2,1.0,0.0,06/18/2024 08:12 AM,5,1,1
1,a3a859c4-a135-11e9-9cda-0a87ae2ba916,5,9,4,1,0,1,0,4.0,1.0,06/18/2024 08:12 AM,5,4,4
1,1934289130932983934,8,7,0,1,0,1,0,0.0,0.0,06/18/2024 08:12 AM,7,0,0
1,a3a96aca-a135-11e9-9cda-0a87ae2ba916,3,8,1,1,0,1,0,0.0,0.0,06/18/2024 08:12 AM,7,1,0
1,a3a82c6c-a135-11e9-9cda-0a87ae2ba916,13,9,0,1,0,1,2,0.0,0.0,06/18/2024 08:12 AM,9,0,0
1,a3b23785-a135-11e9-9cda-0a87ae2ba916,1,10,0,1,0,1,0,0.0,0.0,06/18/2024 08:12 AM,10,0,0
1,a3ad7636-a135-11e9-9cda-0a87ae2ba916,4,6,1,1,0,1,1,0.0,0.0,06/18/2024 08:12 AM,5,1,0
1,a3b20960-a135-11e9-9cda-0a87ae2ba916,2,5,0,1,0,1,0,0.0,0.0,06/18/2024 08:12 AM,5,0,0
1,1871993715238611622,10,4,1,1,0,1,1,0.0,0.0,06/18/2024 08:12 AM,3,1,0
1,a3a7f0ba-a135-11e9-9cda-0a87ae2ba916,1,13,0,1,0,1,0,1.0,0.0,06/18/2024 08:12 AM,13,0,1
1,a3aae35a-a135-11e9-9cda-0a87ae2ba916,6,8,1,1,0,1,0,0.0,0.0,06/18/2024 08:12 AM,7,1,0
1,a3ab9119-a135-11e9-9cda-0a87ae2ba916,7,31,16,1,0,1,5,3.0,1.0,06/18/2024 08:13 AM,13,16,0
1,a3afd294-a135-11e9-9cda-0a87ae2ba916,7,8,2,1,0,1,0,0.0,0.0,06/18/2024 08:13 AM,6,2,0
1,1943245395846580390,13,2,1,1,0,1,0,0.0,0.0,06/18/2024 08:13 AM,1,1,0
1,1936552461714393094,10,3,0,1,0,1,2,0.0,0.0,06/18/2024 08:13 AM,3,0,0
1,a3a795d7-a135-11e9-9cda-0a87ae2ba916,16,3,0,1,0,1,0,0.0,0.0,06/18/2024 08:13 AM,3,0,0
1,1934288718318207280,4,8,4,1,0,1,2,0.0,0.0,06/18/2024 08:13 AM,4,4,0
1,a3b24701-a135-11e9-9cda-0a87ae2ba916,5,5,2,1,0,1,1,0.0,0.0,06/18/2024 08:13 AM,3,2,0
1,a60781db-2bec-4a15-a4a2-363297aefcec,4,10,1,1,0,1,1,0.0,0.0,06/18/2024 08:13 AM,9,1,0
1,a3b2c87c-a135-11e9-9cda-0a87ae2ba916,3,10,2,1,0,1,2,0.0,0.0,06/18/2024 08:13 AM,8,2,0
1,1945195957167804800,1,11,0,1,0,1,3,0.0,0.0,06/18/2024 08:13 AM,11,0,0
1,a3a854bf-a135-11e9-9cda-0a87ae2ba916,8,7,0,1,0,1,0,0.0,0.0,06/18/2024 08:13 AM,7,0,0
1,a3b419d9-a135-11e9-9cda-0a87ae2ba916,2,12,0,1,0,1,1,0.0,0.0,06/18/2024 08:13 AM,12,0,0
1,a3a5a9d0-a135-11e9-9cda-0a87ae2ba916,3,14,3,1,0,1,2,0.0,0.0,06/18/2024 08:13 AM,11,3,0
1,1933998036428004326,4,8,0,1,0,1,3,0.0,0.0,06/18/2024 08:13 AM,8,0,0
1,a3a62566-a135-11e9-9cda-0a87ae2ba916,5,7,1,1,0,1,3,3.0,0.0,06/18/2024 08:13 AM,6,2,3
1,a3a5de24-a135-11e9-9cda-0a87ae2ba916,7,6,1,1,0,1,0,2.0,0.0,06/18/2024 08:13 AM,5,1,0
1,1862806445904101456,30,5,0,1,0,1,0,4.0,0.0,06/18/2024 08:13 AM,5,0,0
1,a3b2d2b7-a135-11e9-9cda-0a87ae2ba916,5,6,0,1,0,1,0,0.0,0.0,06/18/2024 08:13 AM,6,0,0
1,1890605196211329420,1,12,0,1,0,1,2,0.0,0.0,06/18/2024 08:13 AM,12,0,0
1,a3afb401-a135-11e9-9cda-0a87ae2ba916,8,6,2,1,0,1,1,1.0,0.0,06/18/2024 08:13 AM,4,2,0
1,1929967657204564894,11,2,2,1,0,1,2,0.0,0.0,06/18/2024 08:13 AM,0,2,0
1,a3a59ec3-a135-11e9-9cda-0a87ae2ba916,3,13,0,1,0,1,3,0.0,0.0,06/18/2024 08:13 AM,13,0,0
1,a3ac30c5-a135-11e9-9cda-0a87ae2ba916,3,9,4,1,0,1,2,0.0,1.0,06/18/2024 08:13 AM,5,4,0
1,a3a80512-a135-11e9-9cda-0a87ae2ba916,7,9,1,1,0,1,1,2.0,0.0,06/18/2024 08:13 AM,8,1,2
1,732c9f35-0c82-4128-acc3-2cf447298b1d,4,10,2,1,0,1,1,0.0,0.0,06/18/2024 08:13 AM,8,2,0
1,a3a3ace6-a135-11e9-9cda-0a87ae2ba916,7,4,0,1,0,1,1,3.0,0.0,06/18/2024 08:13 AM,4,0,3
1,1931696364106218226,3,10,5,1,0,1,2,0.0,0.0,06/18/2024 08:13 AM,5,5,0
1,a3b3634c-a135-11e9-9cda-0a87ae2ba916,0,14,7,1,0,1,1,0.0,0.0,06/18/2024 08:13 AM,7,7,0
1,1934289944388426278,7,7,3,1,0,1,1,0.0,0.0,06/18/2024 08:13 AM,4,3,0
1,a3a9c5f7-a135-11e9-9cda-0a87ae2ba916,2,5,0,1,0,1,0,0.0,0.0,06/18/2024 08:13 AM,5,0,0
1,a3aa4017-a135-11e9-9cda-0a87ae2ba916,7,1,0,1,0,1,5,1.0,0.0,06/18/2024 08:13 AM,0,0,0
1,1934289361049585738,10,5,0,1,0,1,0,0.0,0.0,06/18/2024 08:13 AM,5,0,0
1,1938034236347042306,7,3,2,1,0,1,5,0.0,0.0,06/18/2024 08:13 AM,1,2,0
1,1850868044363584392,6,8,2,1,0,1,0,1.0,0.0,06/18/2024 08:13 AM,6,2,0
1,94788869-1849-43f6-99e1-2eacbc3fab03,6,10,0,1,0,1,0,2.0,0.0,06/18/2024 08:13 AM,10,0,0
1,a3af5d1c-a135-11e9-9cda-0a87ae2ba916,5,8,6,1,0,1,2,0.0,0.0,06/18/2024 08:13 AM,2,6,0
1,a3b13e66-a135-11e9-9cda-0a87ae2ba916,8,3,0,1,0,1,0,0.0,0.0,06/18/2024 08:13 AM,3,0,0
1,a3b481e1-a135-11e9-9cda-0a87ae2ba916,10,2,0,1,0,1,3,0.0,0.0,06/18/2024 08:13 AM,2,0,0
1,1934290380966283526,4,10,0,1,0,1,1,0.0,0.0,06/18/2024 08:13 AM,10,0,0
1,a3ac1607-a135-11e9-9cda-0a87ae2ba916,7,5,0,1,0,1,3,0.0,0.0,06/18/2024 08:13 AM,5,0,0
1,a3a4ac3f-a135-11e9-9cda-0a87ae2ba916,1,22,6,1,0,1,3,1.0,0.0,06/18/2024 08:13 AM,16,6,0
1,a3a75885-a135-11e9-9cda-0a87ae2ba916,11,9,0,1,0,1,1,0.0,0.0,06/18/2024 08:13 AM,9,0,0
1,a3ae87fa-a135-11e9-9cda-0a87ae2ba916,3,14,1,1,0,1,4,2.0,0.0,06/18/2024 08:13 AM,13,1,0
1,a3b3915a-a135-11e9-9cda-0a87ae2ba916,1,18,2,1,0,1,0,0.0,0.0,06/18/2024 08:13 AM,16,2,0
1,1882466626513795782,3,9,8,1,0,1,3,0.0,0.0,06/18/2024 08:13 AM,1,8,0
0,1958860355622110046,0,0,0,0,0,0,0,,,01/01/1970 06:00 PM,0,0,0
1,1945178760530424534,13,1,0,1,0,1,0,0.0,0.0,06/18/2024 08:09 AM,1,0,0
1,a3a61a0b-a135-11e9-9cda-0a87ae2ba916,5,6,2,1,0,1,2,0.0,0.0,06/18/2024 08:11 AM,4,2,0
1,a3ad7b51-a135-11e9-9cda-0a87ae2ba916,2,6,2,1,0,1,3,0.0,0.0,06/18/2024 08:11 AM,4,2,0
1,a3a62025-a135-11e9-9cda-0a87ae2ba916,5,9,0,1,0,1,4,1.0,0.0,06/18/2024 08:11 AM,9,0,0
1,a3a7af11-a135-11e9-9cda-0a87ae2ba916,2,11,6,1,0,1,2,0.0,0.0,06/18/2024 08:11 AM,5,6,0
1,a3b310ac-a135-11e9-9cda-0a87ae2ba916,5,7,0,1,0,1,3,0.0,0.0,06/18/2024 08:11 AM,7,0,0
1,b43a9764-2b1d-4fa0-a13f-7e05eddc7fcd,11,12,3,1,0,1,0,0.0,0.0,06/18/2024 08:11 AM,9,3,0
1,a3aa91f4-a135-11e9-9cda-0a87ae2ba916,4,8,1,1,0,1,1,1.0,0.0,06/18/2024 08:11 AM,7,1,0
1,a3a58ee0-a135-11e9-9cda-0a87ae2ba916,3,5,0,1,0,1,2,5.0,0.0,06/18/2024 08:11 AM,5,0,0
1,a3a6fcac-a135-11e9-9cda-0a87ae2ba916,16,6,0,1,0,1,1,0.0,0.0,06/18/2024 08:11 AM,6,0,0
1,22afe78c-e8f7-4a80-969e-7ddeafdf49da,5,8,4,1,0,1,2,0.0,0.0,06/18/2024 08:11 AM,4,4,0
1,a3ac7978-a135-11e9-9cda-0a87ae2ba916,4,5,1,1,0,1,2,0.0,1.0,06/18/2024 08:11 AM,4,1,0
1,1929121887488481484,5,6,3,1,0,1,0,0.0,0.0,06/18/2024 08:11 AM,3,3,0
1,a3b4728f-a135-11e9-9cda-0a87ae2ba916,5,3,0,1,0,1,2,0.0,1.0,06/18/2024 08:11 AM,3,0,0
1,a3b21de7-a135-11e9-9cda-0a87ae2ba916,10,1,0,1,0,1,0,0.0,0.0,06/18/2024 08:11 AM,1,0,0
1,a3a5d8db-a135-11e9-9cda-0a87ae2ba916,10,8,0,1,0,1,1,0.0,0.0,06/18/2024 08:11 AM,8,0,0
1,a3b46866-a135-11e9-9cda-0a87ae2ba916,5,5,1,1,0,1,1,0.0,0.0,06/18/2024 08:11 AM,4,1,0
1,a3a3bc53-a135-11e9-9cda-0a87ae2ba916,1,8,5,1,0,1,0,6.0,0.0,06/18/2024 08:11 AM,3,5,6
1,a3aa4f80-a135-11e9-9cda-0a87ae2ba916,9,5,0,1,0,1,1,0.0,0.0,06/18/2024 08:11 AM,5,0,0
1,a3a6e359-a135-11e9-9cda-0a87ae2ba916,6,6,3,1,0,1,1,2.0,0.0,06/18/2024 08:11 AM,3,3,0
1,1871990322214447924,1,10,1,1,0,1,2,2.0,0.0,06/18/2024 08:11 AM,9,1,0
1,c1f104db-9ee7-4999-bd4a-ddd766c75e04,4,6,5,1,0,1,1,0.0,0.0,06/18/2024 08:11 AM,1,5,0
1,1890603435601779460,9,6,1,1,0,1,0,0.0,0.0,06/18/2024 08:12 AM,5,1,0
1,a3a41526-a135-11e9-9cda-0a87ae2ba916,16,23,3,1,0,1,4,0.0,0.0,06/18/2024 08:12 AM,20,3,0
1,a3b00055-a135-11e9-9cda-0a87ae2ba916,8,7,3,1,0,1,0,0.0,0.0,06/18/2024 08:11 AM,4,3,0
1,a3a6f7a5-a135-11e9-9cda-0a87ae2ba916,0,22,14,1,0,1,4,9.0,0.0,06/18/2024 08:12 AM,8,14,9
1,1863873701095594368,9,5,0,1,0,1,1,0.0,0.0,06/18/2024 08:11 AM,5,0,0
1,a3a3a7b4-a135-11e9-9cda-0a87ae2ba916,3,12,0,1,0,1,0,0.0,0.0,06/18/2024 08:12 AM,12,0,0
1,1927677528601722888,10,5,4,1,0,1,0,0.0,0.0,06/18/2024 08:12 AM,1,4,0
1,a065d29d-a081-47f4-8d0f-9a572f6085fe,11,1,0,1,0,1,3,0.0,0.0,06/18/2024 08:12 AM,1,0,0
1,a3a378ca-a135-11e9-9cda-0a87ae2ba916,8,9,0,1,0,1,6,0.0,0.0,06/18/2024 08:12 AM,9,0,0
1,1934290793283144612,8,6,2,1,0,1,1,0.0,0.0,06/18/2024 08:12 AM,4,2,0
1,a3a4f46b-a135-11e9-9cda-0a87ae2ba916,12,8,2,1,0,1,2,0.0,0.0,06/18/2024 08:12 AM,6,2,0
1,a3af624c-a135-11e9-9cda-0a87ae2ba916,3,5,1,1,0,1,1,2.0,0.0,06/18/2024 08:12 AM,4,1,0
1,a3b241df-a135-11e9-9cda-0a87ae2ba916,5,2,1,1,0,1,0,0.0,0.0,06/18/2024 08:12 AM,1,1,0
1,a3a434ce-a135-11e9-9cda-0a87ae2ba916,13,6,0,1,0,1,0,0.0,0.0,06/18/2024 08:12 AM,6,0,0
1,a3a88f84-a135-11e9-9cda-0a87ae2ba916,3,13,2,1,0,1,2,1.0,0.0,06/18/2024 08:12 AM,11,2,0
1,a3b10f66-a135-11e9-9cda-0a87ae2ba916,7,4,1,1,0,1,0,0.0,0.0,06/18/2024 08:12 AM,3,1,0
1,a3b3686c-a135-11e9-9cda-0a87ae2ba916,8,7,6,1,0,1,0,0.0,0.0,06/18/2024 08:12 AM,1,6,0
1,a3a8224f-a135-11e9-9cda-0a87ae2ba916,11,7,0,1,0,1,2,3.0,0.0,06/18/2024 08:12 AM,7,0,0
1,a3b22815-a135-11e9-9cda-0a87ae2ba916,3,7,6,1,0,1,0,0.0,0.0,06/18/2024 08:12 AM,1,6,0
1,a3a9a778-a135-11e9-9cda-0a87ae2ba916,13,2,1,1,0,1,0,0.0,0.0,06/18/2024 08:12 AM,1,1,0
1,a3b29a90-a135-11e9-9cda-0a87ae2ba916,5,6,0,1,0,1,0,0.0,0.0,06/18/2024 08:12 AM,6,0,0
1,a3a42a93-a135-11e9-9cda-0a87ae2ba916,16,7,3,1,0,1,0,0.0,0.0,06/18/2024 08:12 AM,4,3,0
1,a3af956e-a135-11e9-9cda-0a87ae2ba916,2,9,3,1,0,1,2,2.0,0.0,06/18/2024 08:12 AM,6,3,0
1,1936582264492460636,8,3,3,1,0,1,3,1.0,0.0,06/18/2024 08:12 AM,0,3,0
1,6fd280b0-74de-4a89-947d-3be40afa079c,7,6,1,1,0,1,2,0.0,0.0,06/18/2024 08:12 AM,5,1,0
1,a3a3f5e9-a135-11e9-9cda-0a87ae2ba916,13,0,0,1,0,1,2,0.0,0.0,06/18/2024 08:12 AM,0,0,0
1,a3a88a6d-a135-11e9-9cda-0a87ae2ba916,2,8,7,1,0,1,1,0.0,0.0,06/18/2024 08:12 AM,1,7,0
1,a3b3820c-a135-11e9-9cda-0a87ae2ba916,14,4,0,1,0,1,0,0.0,1.0,06/18/2024 08:12 AM,4,0,0
1,a3a3eb9a-a135-11e9-9cda-0a87ae2ba916,6,10,0,1,0,1,2,0.0,1.0,06/18/2024 08:12 AM,10,0,0
1,1945195755748241796,13,1,0,1,0,1,1,0.0,0.0,06/18/2024 08:12 AM,1,0,0
1,1932496568454183892,9,6,3,1,0,1,0,0.0,0.0,06/18/2024 08:12 AM,3,3,0
1,a3ad8aa3-a135-11e9-9cda-0a87ae2ba916,3,12,1,1,0,1,0,0.0,0.0,06/18/2024 08:12 AM,11,1,0
1,a3acd5b1-a135-11e9-9cda-0a87ae2ba916,3,5,1,1,0,1,3,0.0,0.0,06/18/2024 08:12 AM,4,1,0
1,8fd03909-317e-4b6c-b8e9-f4c28b4c90b1,9,5,0,1,0,1,1,0.0,0.0,06/18/2024 08:12 AM,5,0,0
1,a3ad1e12-a135-11e9-9cda-0a87ae2ba916,6,6,0,1,0,1,2,1.0,0.0,06/18/2024 08:12 AM,6,0,1
1,1958859209051740602,7,2,0,1,0,1,0,6.0,0.0,06/18/2024 08:12 AM,2,0,0
1,1936566008041245278,5,3,2,1,0,1,3,0.0,0.0,06/18/2024 08:12 AM,1,2,0
1,1863873159929715228,9,6,0,1,0,1,0,0.0,0.0,06/18/2024 08:12 AM,6,0,0
1,a3b218cd-a135-11e9-9cda-0a87ae2ba916,6,3,1,1,0,1,2,0.0,0.0,06/18/2024 08:12 AM,2,1,0
1,1939906971867155378,5,9,3,1,0,1,1,0.0,0.0,06/18/2024 08:12 AM,6,3,0
1,a3b0d1d5-a135-11e9-9cda-0a87ae2ba916,8,10,2,1,0,1,1,0.0,0.0,06/18/2024 08:12 AM,8,2,0
1,a3b3968b-a135-11e9-9cda-0a87ae2ba916,9,0,0,1,0,1,6,0.0,0.0,06/18/2024 08:12 AM,0,0,0
1,1930641272056945296,7,7,5,1,0,1,1,0.0,0.0,06/18/2024 08:12 AM,2,5,0
1,a3a46896-a135-11e9-9cda-0a87ae2ba916,7,17,5,1,0,1,0,2.0,0.0,06/18/2024 08:12 AM,12,5,2
1,a3ad5c90-a135-11e9-9cda-0a87ae2ba916,10,4,0,1,0,1,1,0.0,0.0,06/18/2024 08:12 AM,4,0,0
1,a3a8711c-a135-11e9-9cda-0a87ae2ba916,9,6,0,1,0,1,2,0.0,0.0,06/18/2024 08:12 AM,6,0,0
1,a3add889-a135-11e9-9cda-0a87ae2ba916,6,4,0,1,0,1,1,0.0,0.0,06/18/2024 08:12 AM,4,0,0
1,1861588043429399408,2,5,0,1,0,1,4,0.0,0.0,06/18/2024 08:12 AM,5,0,0
1,a3b42a3e-a135-11e9-9cda-0a87ae2ba916,8,3,2,1,0,1,0,0.0,0.0,06/18/2024 08:12 AM,1,2,0
1,a3b25656-a135-11e9-9cda-0a87ae2ba916,6,4,0,1,0,1,1,0.0,0.0,06/18/2024 08:12 AM,4,0,0
1,1850867138125484782,5,6,5,1,0,1,0,0.0,0.0,06/18/2024 08:12 AM,1,5,0
1,a3a771c2-a135-11e9-9cda-0a87ae2ba916,9,3,0,1,0,1,0,3.0,0.0,06/18/2024 08:12 AM,3,0,0
1,a3a46e71-a135-11e9-9cda-0a87ae2ba916,1,25,10,1,0,1,6,3.0,0.0,06/18/2024 08:12 AM,15,10,3
1,c4040b17-88bd-40ab-9aae-2655d6771580,9,6,0,1,0,1,0,0.0,0.0,06/18/2024 08:12 AM,6,0,0
1,a3acacbc-a135-11e9-9cda-0a87ae2ba916,1,12,3,1,0,1,1,1.0,0.0,06/18/2024 08:12 AM,9,3,0
1,a3aa7373-a135-11e9-9cda-0a87ae2ba916,2,13,6,1,0,1,0,0.0,0.0,06/18/2024 08:12 AM,7,6,0
1,a3a9acc5-a135-11e9-9cda-0a87ae2ba916,2,7,1,1,0,1,2,0.0,0.0,06/18/2024 08:12 AM,6,1,0
1,a3ad8587-a135-11e9-9cda-0a87ae2ba916,0,27,1,1,0,1,0,0.0,0.0,06/18/2024 08:12 AM,26,1,0
1,a3a44ec7-a135-11e9-9cda-0a87ae2ba916,18,0,0,1,0,1,1,0.0,0.0,06/18/2024 08:12 AM,0,0,0
1,1926946441362045298,12,3,3,1,0,1,0,0.0,0.0,06/18/2024 08:12 AM,0,3,0
1,a3a5af44-a135-11e9-9cda-0a87ae2ba916,1,9,4,1,0,1,1,3.0,0.0,06/18/2024 08:12 AM,5,4,3
1,1934290131858180982,4,6,0,1,0,1,5,0.0,0.0,06/18/2024 08:11 AM,6,0,0
1,a3ab8bee-a135-11e9-9cda-0a87ae2ba916,1,12,1,1,0,1,0,2.0,0.0,06/18/2024 08:11 AM,11,1,0
1,a3a5b496-a135-11e9-9cda-0a87ae2ba916,3,11,1,1,0,1,0,1.0,0.0,06/18/2024 08:11 AM,10,1,0
1,a3a5f0b8-a135-11e9-9cda-0a87ae2ba916,9,2,0,1,0,1,2,6.0,0.0,06/18/2024 08:11 AM,2,0,5
1,a3af2216-a135-11e9-9cda-0a87ae2ba916,0,10,6,1,0,1,0,1.0,0.0,06/18/2024 08:11 AM,4,6,0
1,1943240055911940522,15,0,0,1,0,1,0,,,06/18/2024 08:11 AM,0,0,0
1,a3aca790-a135-11e9-9cda-0a87ae2ba916,8,18,0,1,0,1,1,0.0,0.0,06/18/2024 08:11 AM,18,0,0
1,a3a4c618-a135-11e9-9cda-0a87ae2ba916,14,4,1,1,0,1,0,0.0,0.0,06/18/2024 08:11 AM,3,1,0
1,1859717449875884116,12,2,0,1,0,1,1,0.0,0.0,06/18/2024 08:11 AM,2,0,0
1,a3b1efd6-a135-11e9-9cda-0a87ae2ba916,7,4,1,1,0,1,0,0.0,0.0,06/18/2024 08:11 AM,3,1,0
1,a3b38728-a135-11e9-9cda-0a87ae2ba916,3,18,1,1,0,1,1,1.0,0.0,06/18/2024 08:11 AM,17,1,1
1,a3aff616-a135-11e9-9cda-0a87ae2ba916,6,6,3,1,0,1,2,0.0,0.0,06/18/2024 08:11 AM,3,3,0
1,a3b02ef1-a135-11e9-9cda-0a87ae2ba916,1,12,0,1,0,1,2,0.0,0.0,06/18/2024 08:11 AM,12,0,0
1,a3b0bd42-a135-11e9-9cda-0a87ae2ba916,6,7,4,1,0,1,1,1.0,0.0,06/18/2024 08:11 AM,3,4,0
1,a3ac4548-a135-11e9-9cda-0a87ae2ba916,12,2,1,1,0,1,1,0.0,0.0,06/18/2024 08:11 AM,1,1,0
1,1871991855517771832,14,0,0,1,0,1,1,0.0,0.0,06/18/2024 08:11 AM,0,0,0
1,391d5cd8-c87c-42f8-94df-823f94284005,5,9,0,1,0,1,1,0.0,0.0,06/18/2024 08:12 AM,9,0,0
1,a3af5804-a135-11e9-9cda-0a87ae2ba916,2,8,7,1,0,1,1,0.0,0.0,06/18/2024 08:12 AM,1,7,0
1,a3ac83bc-a135-11e9-9cda-0a87ae2ba916,8,3,0,1,0,1,4,0.0,0.0,06/18/2024 08:12 AM,3,0,0
1,a3b0d6ec-a135-11e9-9cda-0a87ae2ba916,3,6,0,1,0,1,2,0.0,0.0,06/18/2024 08:12 AM,6,0,0
1,a3b2b92c-a135-11e9-9cda-0a87ae2ba916,2,8,0,1,0,1,1,0.0,0.0,06/18/2024 08:12 AM,8,0,0
1,a3b26084-a135-11e9-9cda-0a87ae2ba916,6,4,0,1,0,1,1,0.0,0.0,06/18/2024 08:12 AM,4,0,0
1,1754781885939323186,0,10,0,1,0,1,1,0.0,0.0,06/18/2024 08:12 AM,10,0,0
1,1872721624592814362,2,13,3,1,0,1,0,0.0,0.0,06/18/2024 08:12 AM,10,3,0
1,c3f1be96-07c2-4c65-8a1d-f2203de88495,7,4,0,1,0,1,4,0.0,0.0,06/18/2024 08:12 AM,4,0,0
1,a3a77c8d-a135-11e9-9cda-0a87ae2ba916,35,7,1,1,0,1,4,1.0,0.0,06/18/2024 08:12 AM,6,1,1
1,a3aab5c1-a135-11e9-9cda-0a87ae2ba916,9,7,5,1,0,1,3,1.0,0.0,06/18/2024 08:12 AM,2,4,0
1,a3a5c440-a135-11e9-9cda-0a87ae2ba916,6,6,0,1,0,1,1,1.0,0.0,06/18/2024 08:12 AM,6,0,0
1,9e5ce0b6-198f-48fa-9363-64ab5ec2b222,13,8,3,1,0,1,2,0.0,0.0,06/18/2024 08:12 AM,5,3,0
1,1870208802121658482,9,5,0,1,0,1,1,0.0,0.0,06/18/2024 08:12 AM,5,0,0
1,a3b1ff34-a135-11e9-9cda-0a87ae2ba916,5,5,2,1,0,1,1,0.0,0.0,06/18/2024 08:12 AM,3,2,0
1,a3ad42c3-a135-11e9-9cda-0a87ae2ba916,4,7,0,1,0,1,0,0.0,0.0,06/18/2024 08:12 AM,7,0,0
1,a3aa59bb-a135-11e9-9cda-0a87ae2ba916,2,8,3,1,0,1,1,0.0,0.0,06/18/2024 08:12 AM,5,3,0
1,a3b11993-a135-11e9-9cda-0a87ae2ba916,3,8,3,1,0,1,0,0.0,0.0,06/18/2024 08:12 AM,5,3,0
1,a3b2e20c-a135-11e9-9cda-0a87ae2ba916,4,6,1,1,0,1,5,0.0,0.0,06/18/2024 08:12 AM,5,1,0
1,1934290608103817582,14,1,0,1,0,1,0,0.0,0.0,06/18/2024 08:12 AM,1,0,0
1,a3a42574-a135-11e9-9cda-0a87ae2ba916,16,16,7,1,0,1,1,1.0,1.0,06/18/2024 08:12 AM,9,7,1
1,a3a64639-a135-11e9-9cda-0a87ae2ba916,5,10,2,1,0,1,0,0.0,0.0,06/18/2024 08:12 AM,8,1,0
1,a3a45e3b-a135-11e9-9cda-0a87ae2ba916,0,24,7,1,0,1,1,13.0,1.0,06/18/2024 08:12 AM,17,7,13
1,a3ab812d-a135-11e9-9cda-0a87ae2ba916,17,9,2,1,1,1,12,0.0,0.0,06/18/2024 08:12 AM,7,2,0
1,a3b49122-a135-11e9-9cda-0a87ae2ba916,4,7,2,1,0,1,4,0.0,0.0,06/18/2024 08:12 AM,5,2,0
1,a3b0eb93-a135-11e9-9cda-0a87ae2ba916,2,9,2,1,0,1,0,0.0,0.0,06/18/2024 08:12 AM,7,2,0
1,1866476559603607834,1,0,0,1,0,1,0,2.0,0.0,06/18/2024 08:12 AM,1,0,0
1,a3a89488-a135-11e9-9cda-0a87ae2ba916,13,6,0,1,0,1,1,0.0,0.0,06/18/2024 08:12 AM,6,0,0
1,a3aaca0e-a135-11e9-9cda-0a87ae2ba916,12,3,0,1,0,1,4,0.0,0.0,06/18/2024 08:13 AM,3,0,0
1,a3b26acf-a135-11e9-9cda-0a87ae2ba916,5,5,1,1,0,1,1,0.0,0.0,06/18/2024 08:13 AM,4,1,0
1,a3ad2843-a135-11e9-9cda-0a87ae2ba916,0,18,1,1,0,1,1,0.0,0.0,06/18/2024 08:13 AM,17,1,0
1,a3b453f2-a135-11e9-9cda-0a87ae2ba916,6,1,0,1,0,1,0,1.0,0.0,06/18/2024 08:13 AM,1,0,0
1,a3a49288-a135-11e9-9cda-0a87ae2ba916,8,11,9,1,0,1,2,4.0,0.0,06/18/2024 08:13 AM,1,9,4
1,1e7e4cf3-a16b-4cb7-9ead-fdd71e07ea77,8,7,1,1,0,1,0,0.0,0.0,06/18/2024 08:13 AM,6,1,0
1,a3aca268-a135-11e9-9cda-0a87ae2ba916,3,7,2,1,0,1,1,0.0,0.0,06/18/2024 08:13 AM,5,2,0
1,a3b30b06-a135-11e9-9cda-0a87ae2ba916,1,1,0,1,0,1,13,0.0,0.0,06/18/2024 08:13 AM,1,0,0
1,a3b2f698-a135-11e9-9cda-0a87ae2ba916,6,6,1,1,0,1,3,0.0,0.0,06/18/2024 08:13 AM,5,1,0
1,a3ac2671-a135-11e9-9cda-0a87ae2ba916,9,5,0,1,0,1,2,0.0,0.0,06/18/2024 08:13 AM,5,0,0
1,a3aa10ca-a135-11e9-9cda-0a87ae2ba916,2,9,6,1,0,1,7,1.0,0.0,06/18/2024 08:13 AM,3,6,0
1,a3a4f993-a135-11e9-9cda-0a87ae2ba916,8,5,0,1,0,1,7,0.0,0.0,06/18/2024 08:13 AM,5,0,0
1,a3adbedf-a135-11e9-9cda-0a87ae2ba916,1,3,2,1,0,1,1,6.0,0.0,06/18/2024 08:13 AM,1,2,0
1,a3a6e866-a135-11e9-9cda-0a87ae2ba916,15,4,1,1,0,1,4,0.0,0.0,06/18/2024 08:13 AM,3,1,0
1,a3a866a5-a135-11e9-9cda-0a87ae2ba916,6,12,0,1,0,1,1,0.0,0.0,06/18/2024 08:13 AM,12,0,0
1,a3b0f0b6-a135-11e9-9cda-0a87ae2ba916,3,10,5,1,0,1,2,0.0,0.0,06/18/2024 08:13 AM,5,5,0
1,a3b20e8a-a135-11e9-9cda-0a87ae2ba916,7,2,0,1,0,1,2,0.0,0.0,06/18/2024 08:13 AM,2,0,0
1,a3b35885-a135-11e9-9cda-0a87ae2ba916,1,9,1,1,0,1,0,0.0,0.0,06/18/2024 08:13 AM,8,1,0
1,a3b2810e-a135-11e9-9cda-0a87ae2ba916,6,5,2,1,0,1,0,0.0,0.0,06/18/2024 08:13 AM,3,2,0
1,1867617341378224632,7,7,2,1,0,1,1,0.0,0.0,06/18/2024 08:13 AM,5,2,0
1,a3aa5ed1-a135-11e9-9cda-0a87ae2ba916,1,9,3,1,0,1,0,1.0,0.0,06/18/2024 08:13 AM,6,3,0
1,a3b1eaa7-a135-11e9-9cda-0a87ae2ba916,4,2,0,1,0,1,1,0.0,0.0,06/18/2024 08:13 AM,2,0,0
1,8995498f-1209-4b06-9317-01cd695b3b61,6,2,0,1,0,1,1,0.0,2.0,06/18/2024 08:13 AM,2,0,0
1,1926982189560422428,2,9,3,1,0,1,4,0.0,0.0,06/18/2024 08:13 AM,6,3,0
1,a3b45e26-a135-11e9-9cda-0a87ae2ba916,5,4,0,1,0,1,2,0.0,0.0,06/18/2024 08:13 AM,4,0,0
1,a3a39301-a135-11e9-9cda-0a87ae2ba916,12,2,1,1,0,1,1,0.0,0.0,06/18/2024 08:13 AM,1,1,0
1,a3afc347-a135-11e9-9cda-0a87ae2ba916,9,9,8,1,0,1,1,0.0,0.0,06/18/2024 08:13 AM,1,8,0
1,a3a6054c-a135-11e9-9cda-0a87ae2ba916,3,8,0,1,0,1,1,3.0,0.0,06/18/2024 08:13 AM,8,0,3
1,a3a4ea00-a135-11e9-9cda-0a87ae2ba916,20,15,7,1,0,1,2,2.0,0.0,06/18/2024 08:13 AM,8,7,2
1,1861613253877461614,11,3,1,1,0,1,1,0.0,0.0,06/18/2024 08:13 AM,2,1,0
1,625e37ea-24ea-4f13-9a54-6322466ec521,11,4,1,1,0,1,0,0.0,0.0,06/18/2024 08:13 AM,3,1,0
1,a3a5a48b-a135-11e9-9cda-0a87ae2ba916,6,11,5,1,0,1,0,2.0,0.0,06/18/2024 08:13 AM,6,5,2
1,a3a7cd56-a135-11e9-9cda-0a87ae2ba916,3,11,7,1,0,1,0,1.0,0.0,06/18/2024 08:13 AM,4,7,1
1,a3afb917-a135-11e9-9cda-0a87ae2ba916,9,6,0,1,0,1,0,0.0,0.0,06/18/2024 08:13 AM,6,0,0
1,a3a7d279-a135-11e9-9cda-0a87ae2ba916,6,2,1,1,0,1,3,0.0,0.0,06/18/2024 08:13 AM,1,1,0
1,1872721263815561908,11,4,0,1,0,1,0,0.0,0.0,06/18/2024 08:13 AM,4,0,0
1,1929121088624564460,1,14,6,1,0,1,0,0.0,0.0,06/18/2024 08:13 AM,8,6,0
1,7e435d2a-617e-4c3f-bed0-a8801c20f265,7,8,0,1,0,1,0,0.0,0.0,06/18/2024 08:13 AM,8,0,0
1,14d6e4b0-d0cc-4ccb-b757-e596d8c24a99,14,1,0,1,0,1,0,0.0,0.0,06/18/2024 08:13 AM,1,0,0
1,a3b377cb-a135-11e9-9cda-0a87ae2ba916,3,4,1,1,0,1,8,0.0,0.0,06/18/2024 08:13 AM,3,1,0
1,a3b300d3-a135-11e9-9cda-0a87ae2ba916,11,2,0,1,0,1,2,0.0,0.0,06/18/2024 08:13 AM,2,0,0
1,a3a4d069-a135-11e9-9cda-0a87ae2ba916,20,8,6,1,0,1,0,1.0,0.0,06/18/2024 08:13 AM,2,8,1
1,61695579-2f75-4090-a071-c76079b5fb5d,0,5,0,1,0,1,2,0.0,0.0,06/18/2024 08:13 AM,5,0,0
1,a3a7dc8c-a135-11e9-9cda-0a87ae2ba916,2,14,9,1,0,1,1,2.0,0.0,06/18/2024 08:13 AM,5,9,2
1,a77136ee-060b-433b-88d0-ec74af1ef7ad,8,6,1,1,0,1,1,0.0,0.0,06/18/2024 08:13 AM,5,1,0
1,a3a57a52-a135-11e9-9cda-0a87ae2ba916,9,2,0,1,0,1,0,0.0,0.0,06/18/2024 08:13 AM,1,0,0
1,1869052846885132442,2,11,1,1,0,1,2,0.0,0.0,06/18/2024 08:13 AM,10,1,0
1,87d2a090-22cd-471b-b622-fef3923999dd,8,7,0,1,0,1,0,0.0,0.0,06/18/2024 08:13 AM,7,0,0
1,a3ad61c2-a135-11e9-9cda-0a87ae2ba916,0,17,5,1,0,1,1,1.0,0.0,06/18/2024 08:13 AM,12,5,0
1,1929121521556988340,4,11,8,1,0,1,0,0.0,0.0,06/18/2024 08:13 AM,3,8,0
1,1866477298337982542,3,0,0,1,0,1,0,1.0,0.0,06/18/2024 08:13 AM,0,0,0
0,1958860132283810038,0,0,0,0,0,0,0,,,01/01/1970 06:00 PM,0,0,0
0,1958859802548216454,0,0,0,0,0,0,0,,,01/01/1970 06:00 PM,0,0,0
1,a3a50ec8-a135-11e9-9cda-0a87ae2ba916,27,17,1,1,0,1,2,1.0,0.0,06/18/2024 08:11 AM,16,1,1
1,a3a503e5-a135-11e9-9cda-0a87ae2ba916,10,6,0,1,0,1,2,1.0,0.0,06/18/2024 08:11 AM,6,0,1
1,a3add365-a135-11e9-9cda-0a87ae2ba916,2,7,4,1,0,1,1,1.0,0.0,06/18/2024 08:11 AM,3,4,0
1,a3a7e19b-a135-11e9-9cda-0a87ae2ba916,10,21,2,1,0,1,0,0.0,0.0,06/18/2024 08:11 AM,20,2,0
1,a3b37ce0-a135-11e9-9cda-0a87ae2ba916,9,9,0,1,0,1,0,0.0,0.0,06/18/2024 08:11 AM,9,0,0
1,a3b42f5f-a135-11e9-9cda-0a87ae2ba916,2,9,0,1,0,1,0,0.0,0.0,06/18/2024 08:11 AM,9,0,0
1,1931391724317609988,4,7,6,1,0,1,0,4.0,0.0,06/18/2024 08:11 AM,1,6,0
1,a3a974e1-a135-11e9-9cda-0a87ae2ba916,6,9,6,1,0,1,1,2.0,1.0,06/18/2024 08:11 AM,3,6,2
1,bbf9b599-1873-4133-b670-a0ef9e5c429c,6,4,0,1,0,1,5,0.0,0.0,06/18/2024 08:11 AM,4,0,0
1,a3aa2abb-a135-11e9-9cda-0a87ae2ba916,4,10,7,1,0,1,4,1.0,0.0,06/18/2024 08:11 AM,3,7,0
1,a3a786ac-a135-11e9-9cda-0a87ae2ba916,3,14,5,1,0,1,2,0.0,0.0,06/18/2024 08:11 AM,9,5,0
1,1936560950769470316,9,6,3,1,0,1,0,0.0,0.0,06/18/2024 08:11 AM,3,3,0
1,a3a3e158-a135-11e9-9cda-0a87ae2ba916,12,9,2,1,0,1,1,1.0,0.0,06/18/2024 08:11 AM,7,2,1
1,9e1fbaaa-e872-4505-ada6-5080e62bef77,6,23,3,1,0,1,1,1.0,0.0,06/18/2024 08:11 AM,20,3,0
1,98fe78dc-4efa-4b39-a47c-0d94abcdb221,6,3,2,1,0,1,1,0.0,0.0,06/18/2024 08:11 AM,1,2,0
1,1775509322900183222,4,7,0,1,0,1,0,0.0,0.0,06/18/2024 08:11 AM,7,0,0
1,a3b0e657-a135-11e9-9cda-0a87ae2ba916,7,7,3,1,0,1,4,1.0,0.0,06/18/2024 08:11 AM,4,2,0
1,1932836901177930130,5,5,0,1,0,1,1,0.0,0.0,06/18/2024 08:11 AM,5,0,0
1,a3acfa38-a135-11e9-9cda-0a87ae2ba916,3,7,1,1,0,1,1,0.0,0.0,06/18/2024 08:11 AM,6,1,0
1,a3a57527-a135-11e9-9cda-0a87ae2ba916,6,15,2,1,0,1,5,0.0,0.0,06/18/2024 08:11 AM,13,2,0
1,a3a9d529-a135-11e9-9cda-0a87ae2ba916,16,7,2,1,0,1,0,0.0,0.0,06/18/2024 08:11 AM,6,2,0
1,7dc58bb9-24de-4544-9a12-c3975139370f,9,6,0,1,0,1,0,0.0,0.0,06/18/2024 08:11 AM,6,0,0
1,1879437308430949172,7,4,0,1,0,1,4,0.0,0.0,06/18/2024 08:11 AM,4,0,0
1,a3aaf7bc-a135-11e9-9cda-0a87ae2ba916,0,8,1,1,0,1,3,0.0,0.0,06/18/2024 08:11 AM,7,1,0
1,a3aa0699-a135-11e9-9cda-0a87ae2ba916,0,12,2,1,0,1,9,1.0,0.0,06/18/2024 08:11 AM,10,2,0
1,1936560699993133354,4,11,1,1,0,1,0,0.0,0.0,06/18/2024 08:11 AM,10,1,0
1,a3afc858-a135-11e9-9cda-0a87ae2ba916,2,8,1,1,0,1,1,0.0,0.0,06/18/2024 08:11 AM,7,1,0
1,a3afa4c3-a135-11e9-9cda-0a87ae2ba916,1,9,0,1,0,1,4,0.0,0.0,06/18/2024 08:11 AM,9,0,0
1,a3afe6ed-a135-11e9-9cda-0a87ae2ba916,4,11,3,1,0,1,0,0.0,0.0,06/18/2024 08:11 AM,8,3,0
1,a3b143aa-a135-11e9-9cda-0a87ae2ba916,2,8,2,1,0,1,1,0.0,0.0,06/18/2024 08:11 AM,6,2,0
1,a3b2e72c-a135-11e9-9cda-0a87ae2ba916,1,4,2,1,0,1,10,0.0,0.0,06/18/2024 08:11 AM,2,2,0
1,1934288914372987240,5,6,4,1,0,1,0,4.0,0.0,06/18/2024 08:11 AM,2,4,0
1,a3a6d371-a135-11e9-9cda-0a87ae2ba916,5,2,2,1,0,1,3,4.0,1.0,06/18/2024 08:11 AM,0,2,0
1,1867616044298100822,5,9,3,1,0,1,1,0.0,0.0,06/18/2024 08:11 AM,6,3,0
1,a3a86c05-a135-11e9-9cda-0a87ae2ba916,23,3,0,1,0,1,1,0.0,0.0,06/18/2024 08:12 AM,3,0,0
1,a3a7b936-a135-11e9-9cda-0a87ae2ba916,7,4,0,1,0,1,0,0.0,0.0,06/18/2024 08:12 AM,4,0,0
1,a3a7258b-a135-11e9-9cda-0a87ae2ba916,0,11,4,1,0,1,1,3.0,0.0,06/18/2024 08:12 AM,7,4,3
1,a3a37378-a135-11e9-9cda-0a87ae2ba916,41,6,3,1,0,1,7,0.0,0.0,06/18/2024 08:12 AM,3,3,0
1,a3b1db23-a135-11e9-9cda-0a87ae2ba916,2,7,1,1,0,1,1,1.0,0.0,06/18/2024 08:12 AM,6,1,0
1,a3b2b419-a135-11e9-9cda-0a87ae2ba916,5,6,0,1,0,1,0,0.0,0.0,06/18/2024 08:11 AM,6,0,0
1,a3a55b3e-a135-11e9-9cda-0a87ae2ba916,16,11,0,1,0,1,0,0.0,0.0,06/18/2024 08:12 AM,10,0,0
1,a3a3983e-a135-11e9-9cda-0a87ae2ba916,1,7,0,1,0,1,3,0.0,0.0,06/18/2024 08:12 AM,7,0,0
1,a3a7a4fc-a135-11e9-9cda-0a87ae2ba916,10,1,0,1,0,1,0,0.0,0.0,06/18/2024 08:12 AM,1,0,0
1,a3aac4f9-a135-11e9-9cda-0a87ae2ba916,10,10,0,1,0,1,3,0.0,0.0,06/18/2024 08:12 AM,10,0,0
1,a3a5eb69-a135-11e9-9cda-0a87ae2ba916,17,6,1,1,0,1,6,1.0,2.0,06/18/2024 08:12 AM,5,0,0
1,a3af8642-a135-11e9-9cda-0a87ae2ba916,3,8,4,1,0,1,2,1.0,1.0,06/18/2024 08:12 AM,4,4,0
1,a3a38363-a135-11e9-9cda-0a87ae2ba916,18,5,0,1,0,1,9,3.0,2.0,06/18/2024 08:12 AM,5,0,3
1,a3ad9ad9-a135-11e9-9cda-0a87ae2ba916,3,7,0,1,0,1,1,0.0,0.0,06/18/2024 08:12 AM,7,0,0
1,a3a56075-a135-11e9-9cda-0a87ae2ba916,25,2,2,1,0,1,0,0.0,0.0,06/18/2024 08:12 AM,0,2,0
1,6997d1fb-9887-4c15-b5db-524d45a2f101,6,4,3,1,0,1,5,0.0,0.0,06/18/2024 08:12 AM,1,3,0
1,1932130426977611818,5,9,0,1,0,1,0,1.0,0.0,06/18/2024 08:12 AM,9,0,0
1,a3b2659d-a135-11e9-9cda-0a87ae2ba916,5,6,2,1,0,1,0,0.0,0.0,06/18/2024 08:12 AM,4,2,0
1,1932113567217736592,6,7,3,1,0,1,2,0.0,0.0,06/18/2024 08:12 AM,4,3,0
1,1932128180709716638,3,8,5,1,0,1,0,0.0,0.0,06/18/2024 08:12 AM,3,5,0
1,a3aa7db3-a135-11e9-9cda-0a87ae2ba916,12,5,2,1,0,1,1,1.0,0.0,06/18/2024 08:12 AM,3,2,0
1,a3a3c174-a135-11e9-9cda-0a87ae2ba916,3,12,0,1,0,1,0,0.0,0.0,06/18/2024 08:12 AM,12,0,0
1,a3a4c0df-a135-11e9-9cda-0a87ae2ba916,16,18,0,1,0,1,2,1.0,1.0,06/18/2024 08:12 AM,18,0,1
1,a3aa9c65-a135-11e9-9cda-0a87ae2ba916,11,3,1,1,0,1,5,0.0,0.0,06/18/2024 08:12 AM,2,1,0
1,a3a4591a-a135-11e9-9cda-0a87ae2ba916,12,24,9,1,0,1,0,6.0,1.0,06/18/2024 08:12 AM,15,9,6
1,a3acd078-a135-11e9-9cda-0a87ae2ba916,5,6,2,1,0,1,0,0.0,0.0,06/18/2024 08:12 AM,4,2,0
1,a3a85eda-a135-11e9-9cda-0a87ae2ba916,3,11,6,1,0,1,1,0.0,0.0,06/18/2024 08:12 AM,5,6,0
1,0eeb6baf-c653-4a1a-af17-99f686116b89,2,10,3,1,0,1,3,0.0,0.0,06/18/2024 08:12 AM,7,3,0
1,a3b43eb7-a135-11e9-9cda-0a87ae2ba916,5,6,0,1,0,1,0,0.0,0.0,06/18/2024 08:12 AM,6,0,0
1,a3a39d55-a135-11e9-9cda-0a87ae2ba916,6,8,2,1,0,1,1,0.0,0.0,06/18/2024 08:12 AM,6,2,0
1,a3ade2c3-a135-11e9-9cda-0a87ae2ba916,0,10,4,1,0,1,1,0.0,0.0,06/18/2024 08:12 AM,6,4,0
1,1945088454548058244,5,6,3,1,0,1,4,0.0,0.0,06/18/2024 08:12 AM,3,3,0
1,1863878044896486356,3,5,1,1,0,1,1,6.0,0.0,06/18/2024 08:12 AM,4,1,0
1,a3a781a6-a135-11e9-9cda-0a87ae2ba916,7,4,2,1,0,1,0,0.0,0.0,06/18/2024 08:12 AM,2,2,0
1,2f5957e4-e83a-4d5a-b073-ec9422989315,9,6,2,1,0,1,0,0.0,0.0,06/18/2024 08:12 AM,4,2,0
1,a3af4b26-a135-11e9-9cda-0a87ae2ba916,6,5,5,1,0,1,3,0.0,0.0,06/18/2024 08:12 AM,0,5,0
1,a3b2956a-a135-11e9-9cda-0a87ae2ba916,5,6,1,1,0,1,0,0.0,0.0,06/18/2024 08:12 AM,5,1,0
1,ad9f8858-dc27-43ca-8fdc-78044b22f1fc,3,12,6,1,0,1,0,0.0,0.0,06/18/2024 08:12 AM,6,6,0
1,1861997616150114834,3,11,3,1,0,1,0,1.0,0.0,06/18/2024 08:12 AM,8,3,0
1,a3b0f5c9-a135-11e9-9cda-0a87ae2ba916,4,2,0,1,0,1,1,0.0,0.0,06/18/2024 08:12 AM,2,0,0
1,a3a5e353-a135-11e9-9cda-0a87ae2ba916,12,3,2,1,0,1,0,0.0,0.0,06/18/2024 08:12 AM,1,2,0
1,1861594737501366386,4,9,1,1,0,1,2,0.0,0.0,06/18/2024 08:12 AM,8,1,0
1,a3af1767-a135-11e9-9cda-0a87ae2ba916,1,16,6,1,0,1,4,1.0,0.0,06/18/2024 08:12 AM,10,6,0
1,1951050538021341810,7,3,1,1,0,1,1,0.0,0.0,06/18/2024 08:12 AM,2,1,0
1,a3aa692e-a135-11e9-9cda-0a87ae2ba916,3,11,5,1,0,1,0,1.0,0.0,06/18/2024 08:12 AM,6,5,0
1,a3a5ce97-a135-11e9-9cda-0a87ae2ba916,4,14,1,1,0,1,0,1.0,0.0,06/18/2024 08:12 AM,13,1,1
1,1927695368784189454,10,5,4,1,0,1,0,0.0,0.0,06/18/2024 08:12 AM,1,4,0
1,a3a513e9-a135-11e9-9cda-0a87ae2ba916,10,9,4,1,0,1,6,5.0,1.0,06/18/2024 08:12 AM,5,4,4
1,a3b38c3f-a135-11e9-9cda-0a87ae2ba916,3,11,5,1,0,1,1,0.0,0.0,06/18/2024 08:12 AM,6,5,0
1,1936566487749193740,4,11,0,1,0,1,0,0.0,0.0,06/18/2024 08:12 AM,11,0,0
1,a3b486f2-a135-11e9-9cda-0a87ae2ba916,8,6,1,1,0,1,1,0.0,0.0,06/18/2024 08:12 AM,5,1,0
1,a3a4cb42-a135-11e9-9cda-0a87ae2ba916,9,11,0,1,0,1,3,0.0,0.0,06/18/2024 08:12 AM,11,0,0
1,a3b128de-a135-11e9-9cda-0a87ae2ba916,4,7,2,1,0,1,0,0.0,0.0,06/18/2024 08:12 AM,5,2,0
1,a3a4d588-a135-11e9-9cda-0a87ae2ba916,16,14,1,1,0,1,0,6.0,3.0,06/18/2024 08:12 AM,13,1,5
1,a3b4a579-a135-11e9-9cda-0a87ae2ba916,6,9,0,1,0,1,0,0.0,0.0,06/18/2024 08:12 AM,9,0,0
1,1945087711550943880,2,12,10,1,0,1,0,1.0,0.0,06/18/2024 08:12 AM,2,10,0
1,a3ac9834-a135-11e9-9cda-0a87ae2ba916,5,6,0,1,0,1,0,0.0,0.0,06/18/2024 08:12 AM,6,0,0
1,bc4d498d-c272-4474-beca-10e5268e7253,9,6,5,1,0,1,0,0.0,0.0,06/18/2024 08:12 AM,1,5,0
1,a3a405a1-a135-11e9-9cda-0a87ae2ba916,3,11,5,1,0,1,1,3.0,0.0,06/18/2024 08:12 AM,6,5,3
1,a3a7be40-a135-11e9-9cda-0a87ae2ba916,0,11,1,1,0,1,1,3.0,0.0,06/18/2024 08:12 AM,10,1,3
1,1867227665093179888,3,8,3,1,0,1,4,0.0,0.0,06/18/2024 08:12 AM,5,3,0
1,a3a4bbba-a135-11e9-9cda-0a87ae2ba916,10,12,7,1,0,1,1,0.0,0.0,06/18/2024 08:12 AM,5,7,0
1,87c01e57-8a00-430d-9eb3-2abe51e535dd,12,3,2,1,0,1,0,0.0,0.0,06/18/2024 08:12 AM,1,2,0
1,a3a3d1b8-a135-11e9-9cda-0a87ae2ba916,1,12,0,1,0,1,1,0.0,0.0,06/18/2024 08:12 AM,12,0,0
1,a3ad6c01-a135-11e9-9cda-0a87ae2ba916,4,8,2,1,0,1,3,0.0,0.0,06/18/2024 08:12 AM,6,2,0
1,a3adce47-a135-11e9-9cda-0a87ae2ba916,10,5,0,1,0,1,0,0.0,0.0,06/18/2024 08:12 AM,5,0,0
1,a3a37e26-a135-11e9-9cda-0a87ae2ba916,12,10,0,1,0,1,1,0.0,0.0,06/18/2024 08:12 AM,10,0,0
1,a3ada002-a135-11e9-9cda-0a87ae2ba916,1,10,2,1,0,1,0,0.0,0.0,06/18/2024 08:12 AM,8,2,0
1,1861589903150238332,10,1,0,1,0,1,3,0.0,0.0,06/18/2024 08:12 AM,1,0,0
1,a3a40ad8-a135-11e9-9cda-0a87ae2ba916,17,8,6,1,0,1,2,0.0,0.0,06/18/2024 08:12 AM,2,6,0
1,a3b0104c-a135-11e9-9cda-0a87ae2ba916,2,12,0,1,0,1,1,0.0,0.0,06/18/2024 08:12 AM,12,0,0
1,a3ae82e0-a135-11e9-9cda-0a87ae2ba916,1,10,3,1,0,1,0,0.0,0.0,06/18/2024 08:12 AM,7,3,0
1,a3a9bbf0-a135-11e9-9cda-0a87ae2ba916,2,12,0,1,0,1,0,1.0,0.0,06/18/2024 08:12 AM,12,0,1
1,1938033609511385892,7,5,0,1,0,1,3,0.0,0.0,06/18/2024 08:12 AM,5,0,0
1,a3af9064-a135-11e9-9cda-0a87ae2ba916,1,10,5,1,0,1,0,0.0,0.0,06/18/2024 08:12 AM,5,5,0
1,a3acef62-a135-11e9-9cda-0a87ae2ba916,10,2,0,1,0,1,3,0.0,0.0,06/18/2024 08:12 AM,2,0,0
1,1945195574597886460,9,5,0,1,0,1,1,0.0,0.0,06/18/2024 08:12 AM,5,0,0
1,a3a4daa1-a135-11e9-9cda-0a87ae2ba916,3,15,7,1,0,1,2,6.0,0.0,06/18/2024 08:12 AM,7,7,7
1,1929934715947649384,3,12,0,1,0,1,0,0.0,0.0,06/18/2024 08:12 AM,12,0,0
1,a3a9a24f-a135-11e9-9cda-0a87ae2ba916,10,5,1,1,0,1,0,0.0,0.0,06/18/2024 08:12 AM,4,1,0
1,1942112671760511044,13,2,0,1,0,1,0,0.0,0.0,06/18/2024 08:12 AM,2,0,0
1,a3aad940-a135-11e9-9cda-0a87ae2ba916,15,0,0,1,0,1,0,,,06/18/2024 08:12 AM,0,0,0
1,6849c4e2-cffa-432b-8d83-5c0524594b4f,10,5,1,1,0,1,0,0.0,0.0,06/18/2024 08:12 AM,4,1,0
1,a3b4afb6-a135-11e9-9cda-0a87ae2ba916,1,14,7,1,0,1,0,0.0,0.0,06/18/2024 08:12 AM,7,7,0
1,a3aa9732-a135-11e9-9cda-0a87ae2ba916,8,11,1,1,0,1,0,1.0,0.0,06/18/2024 08:12 AM,10,1,0
1,a3a43f48-a135-11e9-9cda-0a87ae2ba916,17,21,13,1,0,1,5,0.0,0.0,06/18/2024 08:12 AM,8,13,0
1,a3a589b9-a135-11e9-9cda-0a87ae2ba916,7,13,8,1,0,1,3,0.0,0.0,06/18/2024 08:12 AM,5,8,0
1,a3b2dcf0-a135-11e9-9cda-0a87ae2ba916,0,11,0,1,0,1,0,0.0,0.0,06/18/2024 08:12 AM,11,0,0
1,a3b424f6-a135-11e9-9cda-0a87ae2ba916,9,6,1,1,0,1,0,0.0,0.0,06/18/2024 08:12 AM,5,1,0
1,a3b24c1f-a135-11e9-9cda-0a87ae2ba916,3,6,1,1,0,1,2,0.0,0.0,06/18/2024 08:12 AM,5,1,0
1,ce334dea-c5ba-45ca-a52d-39dc161683b0,2,12,11,1,0,1,1,0.0,0.0,06/18/2024 08:12 AM,1,11,0
1,a3a53843-a135-11e9-9cda-0a87ae2ba916,1,11,6,1,0,1,1,2.0,0.0,06/18/2024 08:12 AM,5,6,2
1,a3a482fb-a135-11e9-9cda-0a87ae2ba916,16,6,3,1,0,1,5,0.0,0.0,06/18/2024 08:12 AM,3,3,0
1,1869036027793202092,9,5,1,1,0,1,1,0.0,0.0,06/18/2024 08:12 AM,4,1,0
1,34dc92b5-7cb7-4536-856b-46644d31b48c,14,1,1,1,0,1,0,0.0,0.0,06/18/2024 08:12 AM,0,1,0
1,a3a9da3b-a135-11e9-9cda-0a87ae2ba916,9,9,0,1,0,1,0,0.0,0.0,06/18/2024 08:13 AM,9,0,0
1,a3ac2b9c-a135-11e9-9cda-0a87ae2ba916,7,8,0,1,0,1,0,0.0,0.0,06/18/2024 08:13 AM,8,0,0
1,0f9b826b-8885-4c25-96fd-9e2c2074c34e,10,5,1,1,0,1,0,0.0,0.0,06/18/2024 08:13 AM,4,1,0
1,a3b49b4c-a135-11e9-9cda-0a87ae2ba916,2,8,0,1,0,1,5,0.0,0.0,06/18/2024 08:12 AM,8,0,0
1,a3a94bc8-a135-11e9-9cda-0a87ae2ba916,8,5,1,1,0,1,0,2.0,0.0,06/18/2024 08:13 AM,4,1,0
1,a3ad711d-a135-11e9-9cda-0a87ae2ba916,10,8,1,1,0,1,1,0.0,0.0,06/18/2024 08:13 AM,7,1,0
1,1934009488956756950,8,6,5,1,0,1,1,0.0,0.0,06/18/2024 08:13 AM,1,5,0
1,a3ada52f-a135-11e9-9cda-0a87ae2ba916,5,6,2,1,0,1,0,0.0,0.0,06/18/2024 08:13 AM,4,2,0
1,a3a9e44a-a135-11e9-9cda-0a87ae2ba916,2,16,11,1,0,1,1,12.0,0.0,06/18/2024 08:13 AM,5,11,10
1,a3af9f99-a135-11e9-9cda-0a87ae2ba916,3,6,5,1,0,1,2,0.0,0.0,06/18/2024 08:13 AM,1,5,0
1,a3acbc0b-a135-11e9-9cda-0a87ae2ba916,0,17,1,1,0,1,1,1.0,0.0,06/18/2024 08:13 AM,16,1,0
1,a3b1cf80-a135-11e9-9cda-0a87ae2ba916,6,5,0,1,0,1,0,0.0,0.0,06/18/2024 08:13 AM,5,0,0
1,a3a59915-a135-11e9-9cda-0a87ae2ba916,1,17,2,1,0,1,1,0.0,0.0,06/18/2024 08:13 AM,15,2,0
1,a3a6f2a2-a135-11e9-9cda-0a87ae2ba916,1,12,0,1,0,1,0,2.0,0.0,06/18/2024 08:13 AM,12,0,0
1,1932441844638063332,6,9,2,1,0,1,0,0.0,0.0,06/18/2024 08:13 AM,7,2,0
1,a3b0dc1f-a135-11e9-9cda-0a87ae2ba916,9,3,2,1,0,1,0,0.0,0.0,06/18/2024 08:13 AM,1,1,0
1,a3af76f8-a135-11e9-9cda-0a87ae2ba916,2,12,5,1,0,1,1,0.0,0.0,06/18/2024 08:13 AM,7,5,0
1,1942118282074374350,0,12,9,1,0,1,3,0.0,0.0,06/18/2024 08:13 AM,3,9,0
1,a3b4aa91-a135-11e9-9cda-0a87ae2ba916,0,7,2,1,0,1,0,0.0,0.0,06/18/2024 08:13 AM,5,2,0
1,a3b372b1-a135-11e9-9cda-0a87ae2ba916,8,3,1,1,0,1,3,0.0,0.0,06/18/2024 08:13 AM,2,1,0
1,a3a8275e-a135-11e9-9cda-0a87ae2ba916,10,3,0,1,0,1,2,0.0,0.0,06/18/2024 08:13 AM,3,0,0
1,a3af6c2f-a135-11e9-9cda-0a87ae2ba916,10,2,0,1,0,1,3,0.0,0.0,06/18/2024 08:13 AM,2,0,0
1,a3ac4a7c-a135-11e9-9cda-0a87ae2ba916,4,5,1,1,0,1,2,0.0,0.0,06/18/2024 08:13 AM,4,1,0
1,a3ad523f-a135-11e9-9cda-0a87ae2ba916,11,4,0,1,0,1,0,0.0,0.0,06/18/2024 08:13 AM,4,0,0
1,a3a6ce53-a135-11e9-9cda-0a87ae2ba916,3,8,2,1,0,1,4,0.0,0.0,06/18/2024 08:13 AM,6,3,0
1,a3af1cec-a135-11e9-9cda-0a87ae2ba916,1,7,4,1,0,1,0,2.0,0.0,06/18/2024 08:13 AM,3,4,0
1,1934289552037596050,5,10,7,1,0,1,0,0.0,0.0,06/18/2024 08:13 AM,3,7,0
1,a3a7c341-a135-11e9-9cda-0a87ae2ba916,3,9,5,1,0,1,2,1.0,0.0,06/18/2024 08:13 AM,4,5,1
1,a3b28b4a-a135-11e9-9cda-0a87ae2ba916,2,9,2,1,0,1,0,0.0,0.0,06/18/2024 08:13 AM,7,2,0
1,3d1da4c7-23c9-4731-81f5-91db08f6c97f,13,2,2,1,0,1,0,0.0,0.0,06/18/2024 08:13 AM,0,2,0
1,a3b41f78-a135-11e9-9cda-0a87ae2ba916,20,8,2,1,0,1,3,0.0,0.0,06/18/2024 08:13 AM,6,1,0
1,a3a453fa-a135-11e9-9cda-0a87ae2ba916,12,18,3,1,0,1,0,0.0,1.0,06/18/2024 08:13 AM,15,3,0
1,4b4b0d88-80e0-4ef9-a8d1-cdd6a16722f9,5,8,2,1,0,1,2,0.0,0.0,06/18/2024 08:13 AM,6,2,0
1,a3a593fc-a135-11e9-9cda-0a87ae2ba916,3,17,1,1,0,1,5,2.0,0.0,06/18/2024 08:13 AM,16,1,0
1,1928795714838393816,0,13,9,1,0,1,2,0.0,0.0,06/18/2024 08:13 AM,4,9,0
1,a3a78bc0-a135-11e9-9cda-0a87ae2ba916,27,21,4,1,0,1,7,0.0,1.0,06/18/2024 08:13 AM,17,4,0
1,1955904736576827886,11,4,4,1,0,1,0,0.0,0.0,06/18/2024 08:13 AM,0,4,0
1,a3a9ecff-a135-11e9-9cda-0a87ae2ba916,6,7,0,1,0,1,1,1.0,0.0,06/18/2024 08:13 AM,7,0,1
1,a3a96fd5-a135-11e9-9cda-0a87ae2ba916,5,4,1,1,0,1,0,2.0,0.0,06/18/2024 08:11 AM,3,1,2
1,a3a81d33-a135-11e9-9cda-0a87ae2ba916,5,11,0,1,0,1,2,0.0,0.0,06/18/2024 08:11 AM,11,0,0
1,1936565171921396140,3,7,3,1,0,1,1,0.0,0.0,06/18/2024 08:11 AM,4,3,0
1,10327d47-3c3a-433e-9e38-80638da64232,2,12,0,1,0,1,1,0.0,0.0,06/18/2024 08:11 AM,12,0,0
1,1955505344233296752,15,0,0,1,0,1,0,,,06/18/2024 08:11 AM,0,0,0
1,a3adaa52-a135-11e9-9cda-0a87ae2ba916,11,0,0,1,0,1,0,,,06/18/2024 08:11 AM,0,0,0
1,aea853ed-c70c-4b1b-a7a8-d33869d8d58d,11,3,1,1,0,1,1,0.0,0.0,06/18/2024 08:11 AM,2,1,0
1,1929537544978749446,5,8,2,1,0,1,1,1.0,0.0,06/18/2024 08:11 AM,6,2,0
1,13820eba-039d-4231-9228-005ab0f4e451,3,4,1,1,0,1,5,3.0,0.0,06/18/2024 08:11 AM,3,1,0
1,a3a80009-a135-11e9-9cda-0a87ae2ba916,5,6,2,1,0,1,0,0.0,0.0,06/18/2024 08:11 AM,4,2,0
1,a3b27bcf-a135-11e9-9cda-0a87ae2ba916,6,4,0,1,0,1,0,1.0,0.0,06/18/2024 08:11 AM,4,0,0
1,a3a9309d-a135-11e9-9cda-0a87ae2ba916,0,8,4,1,0,1,6,0.0,0.0,06/18/2024 08:11 AM,4,4,0
1,a3aaaba2-a135-11e9-9cda-0a87ae2ba916,1,12,4,1,0,1,0,2.0,0.0,06/18/2024 08:11 AM,8,4,0
1,a3a4499f-a135-11e9-9cda-0a87ae2ba916,4,10,1,1,0,1,1,0.0,0.0,06/18/2024 08:11 AM,9,1,0
1,a3ae7dc3-a135-11e9-9cda-0a87ae2ba916,5,7,1,1,0,1,3,0.0,0.0,06/18/2024 08:11 AM,6,1,0
1,a3b4497a-a135-11e9-9cda-0a87ae2ba916,2,9,3,1,0,1,0,0.0,0.0,06/18/2024 08:11 AM,6,3,0
1,a3adc925-a135-11e9-9cda-0a87ae2ba916,6,9,0,1,0,1,0,0.0,0.0,06/18/2024 08:11 AM,9,0,0
1,a3aacf29-a135-11e9-9cda-0a87ae2ba916,11,10,0,1,0,1,6,0.0,0.0,06/18/2024 08:11 AM,10,0,0
1,1879441011318372516,8,3,0,1,0,1,0,0.0,0.0,06/18/2024 08:11 AM,3,0,0
1,a3b024aa-a135-11e9-9cda-0a87ae2ba916,10,4,1,1,0,1,0,1.0,0.0,06/18/2024 08:11 AM,3,1,0
1,a3ae78ab-a135-11e9-9cda-0a87ae2ba916,9,1,0,1,0,1,1,0.0,0.0,06/18/2024 08:11 AM,1,0,0
1,1929119555906179916,5,9,2,1,0,1,1,0.0,0.0,06/18/2024 08:11 AM,7,2,0
1,a3b2044b-a135-11e9-9cda-0a87ae2ba916,8,3,0,1,0,1,0,0.0,0.0,06/18/2024 08:11 AM,3,0,0
1,a3ad66e6-a135-11e9-9cda-0a87ae2ba916,2,5,1,1,0,1,4,0.0,0.0,06/18/2024 08:11 AM,4,1,0
1,a3ae923d-a135-11e9-9cda-0a87ae2ba916,3,7,5,1,0,1,4,1.0,0.0,06/18/2024 08:11 AM,2,5,0
1,1890604055552786620,5,9,4,1,0,1,1,0.0,0.0,06/18/2024 08:12 AM,5,4,0
1,a3a4203a-a135-11e9-9cda-0a87ae2ba916,8,8,3,1,0,1,0,3.0,0.0,06/18/2024 08:12 AM,5,3,3
1,95185a0d-da45-406a-a892-6b37b0d29fa8,7,7,4,1,0,1,1,0.0,0.0,06/18/2024 08:12 AM,3,4,0
1,a3a4fec3-a135-11e9-9cda-0a87ae2ba916,4,15,0,1,0,1,0,0.0,0.0,06/18/2024 08:12 AM,15,0,0
1,a3ade7de-a135-11e9-9cda-0a87ae2ba916,5,1,1,1,0,1,1,0.0,0.0,06/18/2024 08:11 AM,0,1,0
1,a3accb60-a135-11e9-9cda-0a87ae2ba916,8,2,1,1,0,1,1,0.0,0.0,06/18/2024 08:12 AM,1,1,0
1,a3a73ef1-a135-11e9-9cda-0a87ae2ba916,4,8,0,1,0,1,3,0.0,0.0,06/18/2024 08:12 AM,8,0,0
1,a3b2c354-a135-11e9-9cda-0a87ae2ba916,3,7,1,1,0,1,1,0.0,0.0,06/18/2024 08:12 AM,6,1,0
1,a3a6c910-a135-11e9-9cda-0a87ae2ba916,4,11,2,1,0,1,0,0.0,0.0,06/18/2024 08:12 AM,9,2,0
1,a3aade4c-a135-11e9-9cda-0a87ae2ba916,8,8,5,1,0,1,2,0.0,0.0,06/18/2024 08:12 AM,3,5,0
1,1884621142190397936,9,4,1,1,0,1,2,0.0,0.0,06/18/2024 08:12 AM,3,1,0
1,1942481603584237586,3,12,10,1,0,1,0,0.0,0.0,06/18/2024 08:12 AM,2,10,0
1,a3a89ea8-a135-11e9-9cda-0a87ae2ba916,9,8,0,1,0,1,0,2.0,0.0,06/18/2024 08:12 AM,8,0,0
1,a3a47dde-a135-11e9-9cda-0a87ae2ba916,6,16,3,1,0,1,1,0.0,0.0,06/18/2024 08:12 AM,13,3,0
1,a3ad0ecb-a135-11e9-9cda-0a87ae2ba916,4,7,1,1,0,1,0,0.0,0.0,06/18/2024 08:12 AM,6,1,0
1,a3aa6e51-a135-11e9-9cda-0a87ae2ba916,8,9,0,1,0,1,1,1.0,0.0,06/18/2024 08:12 AM,9,0,0
1,a3acc133-a135-11e9-9cda-0a87ae2ba916,11,18,6,1,0,1,0,2.0,0.0,06/18/2024 08:12 AM,12,6,2
1,a3a51934-a135-11e9-9cda-0a87ae2ba916,12,3,0,1,0,1,4,0.0,0.0,06/18/2024 08:12 AM,3,0,0
1,1872722290312745226,2,13,0,1,0,1,0,0.0,0.0,06/18/2024 08:12 AM,13,0,0
1,a3a7aa0e-a135-11e9-9cda-0a87ae2ba916,5,4,1,1,0,1,1,1.0,0.0,06/18/2024 08:12 AM,3,1,1
1,b8c74f86-2873-4818-88ac-81d9ae374add,7,4,0,1,1,1,6,0.0,1.0,06/18/2024 08:12 AM,4,0,0
1,a3b01f9c-a135-11e9-9cda-0a87ae2ba916,0,12,1,1,0,1,1,2.0,0.0,06/18/2024 08:12 AM,11,1,0
1,1928767416660546464,3,11,8,1,0,1,1,0.0,0.0,06/18/2024 08:12 AM,3,8,0
1,a3b25b6d-a135-11e9-9cda-0a87ae2ba916,0,6,2,1,0,1,1,0.0,0.0,06/18/2024 08:12 AM,4,2,0
1,56eccb5b-f4d7-43c5-b554-a6a0a7585e5e,5,9,4,1,0,1,1,0.0,0.0,06/18/2024 08:12 AM,5,4,0
1,a3a5b9d3-a135-11e9-9cda-0a87ae2ba916,7,5,0,1,0,1,1,1.0,0.0,06/18/2024 08:12 AM,5,0,1
1,a3a41af5-a135-11e9-9cda-0a87ae2ba916,13,16,3,1,0,1,4,4.0,1.0,06/18/2024 08:12 AM,13,3,4
1,1932441496569160306,2,13,10,1,0,1,0,0.0,0.0,06/18/2024 08:12 AM,3,10,0
1,a3a3d6f0-a135-11e9-9cda-0a87ae2ba916,1,10,0,1,0,1,4,0.0,0.0,06/18/2024 08:12 AM,10,0,0
1,a3a3dc37-a135-11e9-9cda-0a87ae2ba916,8,6,1,1,0,1,1,0.0,0.0,06/18/2024 08:12 AM,5,1,0
1,a3a743ff-a135-11e9-9cda-0a87ae2ba916,0,14,2,1,0,1,1,0.0,0.0,06/18/2024 08:12 AM,12,2,0
1,a3b12dfb-a135-11e9-9cda-0a87ae2ba916,3,8,0,1,0,1,0,0.0,0.0,06/18/2024 08:12 AM,8,0,0
1,a3a84fb8-a135-11e9-9cda-0a87ae2ba916,11,7,2,1,0,1,1,0.0,0.0,06/18/2024 08:12 AM,5,2,0
1,1871992684446460008,1,12,4,1,0,1,2,0.0,0.0,06/18/2024 08:12 AM,8,4,0
1,a3a4b693-a135-11e9-9cda-0a87ae2ba916,3,15,1,1,0,1,3,2.0,0.0,06/18/2024 08:12 AM,14,1,2
1,a3a7eba7-a135-11e9-9cda-0a87ae2ba916,7,16,1,1,0,1,0,0.0,0.0,06/18/2024 08:12 AM,15,1,0
1,a3a53d70-a135-11e9-9cda-0a87ae2ba916,10,6,1,1,0,1,3,0.0,0.0,06/18/2024 08:12 AM,5,1,0
1,7c56e4d5-92ee-4129-9a3a-d2ce89eab31d,3,11,2,1,0,1,0,0.0,0.0,06/18/2024 08:12 AM,9,2,0
1,a3a84ab4-a135-11e9-9cda-0a87ae2ba916,13,0,0,1,0,1,2,0.0,0.0,06/18/2024 08:12 AM,0,0,0
1,a3a4ef26-a135-11e9-9cda-0a87ae2ba916,9,4,0,1,0,1,6,0.0,0.0,06/18/2024 08:12 AM,4,0,0
1,1861996658372408268,4,8,4,1,0,1,1,2.0,0.0,06/18/2024 08:12 AM,4,4,0
1,1943243743326460398,6,9,4,1,0,1,0,0.0,0.0,06/18/2024 08:12 AM,5,4,0
1,a3acdff9-a135-11e9-9cda-0a87ae2ba916,0,8,0,1,0,1,2,0.0,1.0,06/18/2024 08:12 AM,8,0,0
1,d6456ded-180b-4d6e-b020-3aa80bce5c2c,8,7,0,1,0,1,0,0.0,0.0,06/18/2024 08:12 AM,7,0,0
1,8759a858-d7eb-4382-b38f-2223c3f9e25d,10,4,0,1,0,1,1,0.0,0.0,06/18/2024 08:12 AM,4,0,0
1,1943243414585123730,8,7,0,1,0,1,0,0.0,0.0,06/18/2024 08:12 AM,7,0,0
1,a3a57f6b-a135-11e9-9cda-0a87ae2ba916,2,10,2,1,0,1,3,0.0,0.0,06/18/2024 08:12 AM,8,2,0
1,a3a640d1-a135-11e9-9cda-0a87ae2ba916,8,11,0,1,0,1,4,4.0,0.0,06/18/2024 08:12 AM,11,0,4
1,2a80f8d9-85dc-4c36-ba07-86d775ffd1ee,6,8,1,1,0,1,1,0.0,0.0,06/18/2024 08:12 AM,7,1,0
1,a3adb9a3-a135-11e9-9cda-0a87ae2ba916,1,18,0,1,0,1,0,0.0,0.0,06/18/2024 08:12 AM,18,0,0
1,a3a50991-a135-11e9-9cda-0a87ae2ba916,14,9,0,1,0,1,7,0.0,0.0,06/18/2024 08:12 AM,9,0,0
1,a4f9ba74-f1cc-4b6a-90ad-78cacd45d3e1,7,7,0,1,0,1,1,0.0,0.0,06/18/2024 08:12 AM,7,0,0
1,4fcebf8a-b065-4cd1-a167-211a45ada30e,10,5,0,1,0,1,0,0.0,0.0,06/18/2024 08:12 AM,5,0,0
1,1866476160171649058,4,7,0,1,0,1,0,1.0,0.0,06/18/2024 08:12 AM,7,0,0
1,97818a9b-0f86-44df-98e6-1bc16812e3d9,8,7,5,1,0,1,4,0.0,0.0,06/18/2024 08:12 AM,2,5,0
1,a3a87631-a135-11e9-9cda-0a87ae2ba916,2,13,11,1,0,1,0,0.0,0.0,06/18/2024 08:12 AM,2,11,0
1,a3aad436-a135-11e9-9cda-0a87ae2ba916,2,15,1,1,0,1,2,1.0,0.0,06/18/2024 08:12 AM,14,1,0
1,a3afcd70-a135-11e9-9cda-0a87ae2ba916,1,14,7,1,0,1,0,1.0,0.0,06/18/2024 08:12 AM,7,7,0
1,1942494597574009470,11,1,1,1,0,1,3,0.0,0.0,06/18/2024 08:12 AM,0,1,0
1,a3b305e7-a135-11e9-9cda-0a87ae2ba916,8,5,2,1,0,1,2,0.0,0.0,06/18/2024 08:12 AM,3,2,0
1,a3a9892f-a135-11e9-9cda-0a87ae2ba916,25,11,0,1,0,1,2,2.0,0.0,06/18/2024 08:12 AM,11,0,0
1,a3a4e4e3-a135-11e9-9cda-0a87ae2ba916,11,8,0,1,0,1,0,0.0,0.0,06/18/2024 08:12 AM,8,0,0
1,080ab938-2c1b-4fcf-a83d-74c5ae6ff305,3,12,0,1,0,1,0,0.0,0.0,06/18/2024 08:12 AM,12,0,0
1,a3ac8dfb-a135-11e9-9cda-0a87ae2ba916,2,12,0,1,0,1,1,0.0,0.0,06/18/2024 08:12 AM,12,0,0
1,a3a49cd7-a135-11e9-9cda-0a87ae2ba916,16,3,0,1,0,1,0,0.0,0.0,06/18/2024 08:12 AM,3,0,0
1,8a677aec-442b-47b8-aff7-50852e1d26c0,4,5,0,1,0,1,2,0.0,0.0,06/18/2024 08:12 AM,5,0,0
1,a3a74947-a135-11e9-9cda-0a87ae2ba916,9,6,0,1,0,1,0,0.0,0.0,06/18/2024 08:12 AM,6,0,0
1,a3a3888b-a135-11e9-9cda-0a87ae2ba916,10,6,1,1,0,1,1,2.0,0.0,06/18/2024 08:12 AM,5,1,2
1,1945195369201185184,0,15,12,1,0,1,0,0.0,0.0,06/18/2024 08:12 AM,3,12,0
1,1936560098166245516,11,4,0,1,0,1,0,0.0,0.0,06/18/2024 08:12 AM,4,0,0
1,a3acc649-a135-11e9-9cda-0a87ae2ba916,4,5,0,1,0,1,2,0.0,0.0,06/18/2024 08:12 AM,5,0,0
1,a3aa2ff4-a135-11e9-9cda-0a87ae2ba916,15,0,0,1,0,1,4,0.0,0.0,06/18/2024 08:12 AM,0,0,0
1,1789242536879942642,9,10,3,1,0,1,0,0.0,0.0,06/18/2024 08:12 AM,8,3,0
1,a3af368c-a135-11e9-9cda-0a87ae2ba916,5,9,7,1,0,1,0,1.0,0.0,06/18/2024 08:12 AM,2,7,0
1,a3ac4024-a135-11e9-9cda-0a87ae2ba916,8,2,0,1,0,1,4,1.0,0.0,06/18/2024 08:12 AM,2,0,0
1,a3a817dc-a135-11e9-9cda-0a87ae2ba916,0,8,2,1,0,1,2,4.0,0.0,06/18/2024 08:12 AM,6,3,4
1,48b2ed2f-18aa-4a9b-b27d-db9f6d0c8c16,8,7,1,1,0,1,0,0.0,0.0,06/18/2024 08:12 AM,6,1,0
1,a3ad3d08-a135-11e9-9cda-0a87ae2ba916,8,3,1,1,0,1,2,2.0,0.0,06/18/2024 08:12 AM,2,1,0
1,a3a9d00a-a135-11e9-9cda-0a87ae2ba916,0,26,13,1,0,1,3,5.0,1.0,06/18/2024 08:12 AM,13,13,5
1,a3b2a9e7-a135-11e9-9cda-0a87ae2ba916,2,9,1,1,0,1,0,0.0,0.0,06/18/2024 08:12 AM,8,1,0
1,a3b0060d-a135-11e9-9cda-0a87ae2ba916,4,12,3,1,0,1,0,0.0,0.0,06/18/2024 08:12 AM,9,2,0
1,a3ad327e-a135-11e9-9cda-0a87ae2ba916,5,4,1,1,0,1,2,0.0,0.0,06/18/2024 08:12 AM,3,1,0
1,a3a46361-a135-11e9-9cda-0a87ae2ba916,8,19,2,1,0,1,6,2.0,0.0,06/18/2024 08:12 AM,17,2,1
1,a3a7537c-a135-11e9-9cda-0a87ae2ba916,18,1,0,1,0,1,4,0.0,0.0,06/18/2024 08:12 AM,1,0,0
1,a3af8b51-a135-11e9-9cda-0a87ae2ba916,1,12,2,1,0,1,1,1.0,0.0,06/18/2024 08:13 AM,10,2,0
1,1879438378503419960,1,6,5,1,0,1,1,3.0,0.0,06/18/2024 08:13 AM,1,5,0
1,a3a53324-a135-11e9-9cda-0a87ae2ba916,45,3,0,1,0,1,3,4.0,0.0,06/18/2024 08:13 AM,3,0,4
1,a3aa7897-a135-11e9-9cda-0a87ae2ba916,2,21,3,1,0,1,0,0.0,0.0,06/18/2024 08:13 AM,18,3,0
1,a3ad5764-a135-11e9-9cda-0a87ae2ba916,8,1,1,1,0,1,2,0.0,0.0,06/18/2024 08:12 AM,0,1,0
1,a3a6de38-a135-11e9-9cda-0a87ae2ba916,3,7,0,1,0,1,1,0.0,0.0,06/18/2024 08:13 AM,7,0,0
1,a3a72aad-a135-11e9-9cda-0a87ae2ba916,37,5,0,1,0,1,1,0.0,0.0,06/18/2024 08:13 AM,5,0,0
1,532a6e43-6efc-4c87-81a8-c75dfd8e8fde,3,10,3,1,1,1,0,0.0,1.0,06/18/2024 08:13 AM,7,3,0
1,a3a478c9-a135-11e9-9cda-0a87ae2ba916,11,5,0,1,0,1,1,2.0,0.0,06/18/2024 08:13 AM,5,0,1
1,a3af40f1-a135-11e9-9cda-0a87ae2ba916,10,4,3,1,0,1,1,0.0,0.0,06/18/2024 08:13 AM,1,2,0
1,1929968520492991056,10,5,0,1,0,1,0,0.0,0.0,06/18/2024 08:13 AM,5,0,0
1,a3a523a6-a135-11e9-9cda-0a87ae2ba916,17,12,1,1,0,1,2,0.0,0.0,06/18/2024 08:12 AM,11,0,0
1,a3aa453c-a135-11e9-9cda-0a87ae2ba916,4,18,3,1,0,1,1,0.0,0.0,06/18/2024 08:13 AM,15,3,0
1,a3a43a25-a135-11e9-9cda-0a87ae2ba916,0,6,0,1,0,1,4,1.0,0.0,06/18/2024 08:13 AM,6,0,1
1,a3a4b164-a135-11e9-9cda-0a87ae2ba916,7,16,5,1,0,1,4,0.0,0.0,06/18/2024 08:13 AM,11,5,0
1,a3aa82d0-a135-11e9-9cda-0a87ae2ba916,9,12,2,1,0,1,0,1.0,0.0,06/18/2024 08:13 AM,10,2,1
1,a3b35e21-a135-11e9-9cda-0a87ae2ba916,7,5,0,1,0,1,3,0.0,0.0,06/18/2024 08:13 AM,5,0,0
1,a3aabfe3-a135-11e9-9cda-0a87ae2ba916,15,4,1,1,0,1,0,0.0,0.0,06/18/2024 08:13 AM,3,1,0
1,a3a734ce-a135-11e9-9cda-0a87ae2ba916,19,16,0,1,0,1,4,0.0,0.0,06/18/2024 08:13 AM,16,0,0
1,a3aa259c-a135-11e9-9cda-0a87ae2ba916,13,1,0,1,0,1,1,0.0,0.0,06/18/2024 08:13 AM,1,0,0
1,1938034793873535334,9,0,0,1,0,1,6,0.0,0.0,06/18/2024 08:13 AM,0,0,0
1,a3b43478-a135-11e9-9cda-0a87ae2ba916,1,4,0,1,0,1,2,0.0,0.0,06/18/2024 08:13 AM,4,0,0
1,1863877673940343638,11,4,0,1,0,1,0,0.0,0.0,06/18/2024 08:13 AM,4,0,0
1,1890604506489868740,6,9,2,1,0,1,0,0.0,0.0,06/18/2024 08:13 AM,7,2,0
1,a3b213af-a135-11e9-9cda-0a87ae2ba916,3,4,2,1,0,1,0,0.0,0.0,06/18/2024 08:13 AM,2,2,0
1,a3a72fc4-a135-11e9-9cda-0a87ae2ba916,12,6,0,1,0,1,0,0.0,0.0,06/18/2024 08:13 AM,5,0,0
1,a3aa017e-a135-11e9-9cda-0a87ae2ba916,9,0,0,1,0,1,1,1.0,0.0,06/18/2024 08:13 AM,0,0,0
1,a3ad2322-a135-11e9-9cda-0a87ae2ba916,7,7,1,1,0,1,0,1.0,0.0,06/18/2024 08:13 AM,6,1,1
1,1936560522747919086,8,5,0,1,0,1,2,0.0,0.0,06/18/2024 08:13 AM,5,0,0
1,d53ae727-5265-4b8e-a6ca-2a36dc0345c4,19,7,3,1,1,1,2,1.0,0.0,06/18/2024 08:13 AM,4,3,0
1,1ce9b7b2-6ef1-4e3b-abd4-85dedaf0ee65,10,4,1,1,0,1,1,0.0,0.0,06/18/2024 08:13 AM,3,1,0
1,a3b1f4fb-a135-11e9-9cda-0a87ae2ba916,6,5,2,1,0,1,0,0.0,0.0,06/18/2024 08:13 AM,3,2,0
1,1955858510671552648,9,6,0,1,0,1,0,0.0,0.0,06/18/2024 08:13 AM,6,0,0
1,a3aa54a0-a135-11e9-9cda-0a87ae2ba916,7,3,1,1,0,1,0,1.0,0.0,06/18/2024 08:13 AM,2,1,0
1,a3a7faf7-a135-11e9-9cda-0a87ae2ba916,2,8,3,1,0,1,3,2.0,0.0,06/18/2024 08:13 AM,5,3,2
1,a3ae8d13-a135-11e9-9cda-0a87ae2ba916,0,8,7,1,0,1,2,0.0,0.0,06/18/2024 08:13 AM,1,7,0
1,1958859390231356014,10,5,5,1,0,1,0,0.0,0.0,06/18/2024 08:13 AM,0,5,0
1,a3a7c852-a135-11e9-9cda-0a87ae2ba916,8,6,0,1,0,1,0,1.0,0.0,06/18/2024 08:13 AM,6,0,1
0,1958859960485118844,0,0,0,0,0,0,0,,,01/01/1970 06:00 PM,0,0,0
1,1945194573870506886,3,10,6,1,0,1,2,0.0,0.0,06/18/2024 08:10 AM,4,6,0
1,1954768541828039308,15,0,0,1,0,1,0,,,06/18/2024 08:11 AM,0,0,0
1,a3aa1623-a135-11e9-9cda-0a87ae2ba916,9,9,1,1,0,1,0,1.0,0.0,06/18/2024 08:11 AM,8,1,0
1,a3a639f5-a135-11e9-9cda-0a87ae2ba916,5,6,0,1,0,1,0,0.0,0.0,06/18/2024 08:11 AM,6,0,0
1,59019cbc-47d4-4743-afb2-e71e9767df0c,3,10,5,1,0,1,2,0.0,0.0,06/18/2024 08:11 AM,5,5,0
1,a3b1ca28-a135-11e9-9cda-0a87ae2ba916,5,6,0,1,0,1,0,0.0,0.0,06/18/2024 08:11 AM,6,0,0
1,a3a95142-a135-11e9-9cda-0a87ae2ba916,9,5,0,1,0,1,1,0.0,0.0,06/18/2024 08:11 AM,5,0,0
1,a3a762a1-a135-11e9-9cda-0a87ae2ba916,2,6,3,1,0,1,3,1.0,0.0,06/18/2024 08:11 AM,3,3,0
1,a3a710c5-a135-11e9-9cda-0a87ae2ba916,9,5,1,1,0,1,1,0.0,0.0,06/18/2024 08:11 AM,4,1,0
1,a3ac0fff-a135-11e9-9cda-0a87ae2ba916,5,13,0,1,0,1,1,0.0,0.0,06/18/2024 08:11 AM,13,0,0
1,a3a701b8-a135-11e9-9cda-0a87ae2ba916,7,8,5,1,0,1,0,0.0,0.0,06/18/2024 08:11 AM,3,5,0
1,1866822399451882164,9,6,2,1,0,1,0,0.0,0.0,06/18/2024 08:11 AM,4,2,0
1,a3ad1900-a135-11e9-9cda-0a87ae2ba916,8,7,0,1,0,1,0,0.0,0.0,06/18/2024 08:11 AM,7,0,0
1,a3a70bbd-a135-11e9-9cda-0a87ae2ba916,11,3,0,1,0,1,3,0.0,1.0,06/18/2024 08:11 AM,3,0,0
1,a3a51e6e-a135-11e9-9cda-0a87ae2ba916,9,4,0,1,0,1,0,2.0,0.0,06/18/2024 08:11 AM,4,0,2
1,a3a9607f-a135-11e9-9cda-0a87ae2ba916,3,25,3,1,0,1,3,0.0,0.0,06/18/2024 08:11 AM,22,3,0
1,a3a7d782-a135-11e9-9cda-0a87ae2ba916,1,22,0,1,0,1,1,3.0,0.0,06/18/2024 08:11 AM,22,0,3
1,a3b26fee-a135-11e9-9cda-0a87ae2ba916,3,7,0,1,0,1,1,0.0,0.0,06/18/2024 08:11 AM,7,0,0
1,a3af71a9-a135-11e9-9cda-0a87ae2ba916,4,5,0,1,0,1,2,0.0,0.0,06/18/2024 08:11 AM,5,0,0
1,a3ad47f8-a135-11e9-9cda-0a87ae2ba916,1,9,0,1,0,1,1,0.0,0.0,06/18/2024 08:11 AM,9,0,0
1,a3afe1dc-a135-11e9-9cda-0a87ae2ba916,0,11,4,1,0,1,0,0.0,0.0,06/18/2024 08:11 AM,7,4,0
1,a3a98429-a135-11e9-9cda-0a87ae2ba916,3,12,5,1,0,1,0,0.0,0.0,06/18/2024 08:11 AM,7,5,0
1,a2aa2a53-3439-459b-9345-c21435e99a72,9,2,0,1,0,1,4,0.0,0.0,06/18/2024 08:11 AM,2,0,0
1,a3a4a202-a135-11e9-9cda-0a87ae2ba916,15,6,1,1,0,1,6,0.0,0.0,06/18/2024 08:11 AM,5,1,0
1,a3a54cdb-a135-11e9-9cda-0a87ae2ba916,6,5,0,1,0,1,0,0.0,0.0,06/18/2024 08:11 AM,5,0,0
1,cefa52d6-b185-4969-89a6-20eb65f5c294,10,4,0,1,0,1,1,0.0,0.0,06/18/2024 08:11 AM,4,0,0
1,a3b2513d-a135-11e9-9cda-0a87ae2ba916,2,4,0,1,0,1,1,0.0,0.0,06/18/2024 08:11 AM,4,0,0
1,1927347094828755902,6,9,2,1,0,1,0,0.0,0.0,06/18/2024 08:11 AM,7,2,0
1,1945194351261708978,15,0,0,1,0,1,0,,,06/18/2024 08:11 AM,0,0,0
1,a3a80f32-a135-11e9-9cda-0a87ae2ba916,10,5,2,1,0,1,1,2.0,0.0,06/18/2024 08:11 AM,3,2,0
1,a3aa3adf-a135-11e9-9cda-0a87ae2ba916,9,7,0,1,0,1,6,0.0,0.0,06/18/2024 08:11 AM,7,0,0
1,a3a56ae5-a135-11e9-9cda-0a87ae2ba916,4,13,1,1,0,1,0,1.0,0.0,06/18/2024 08:11 AM,12,1,1
1,1933956482619414962,6,8,6,1,0,1,1,0.0,0.0,06/18/2024 08:11 AM,2,6,0
1,a3b2cd97-a135-11e9-9cda-0a87ae2ba916,1,10,6,1,0,1,0,0.0,0.0,06/18/2024 08:11 AM,4,6,0
1,1934288056893243658,5,9,1,1,0,1,1,0.0,0.0,06/18/2024 08:11 AM,8,1,0
1,a3b39bb0-a135-11e9-9cda-0a87ae2ba916,0,9,2,1,0,1,1,1.0,0.0,06/18/2024 08:11 AM,7,2,1
1,a3b0fff9-a135-11e9-9cda-0a87ae2ba916,1,9,7,1,0,1,1,0.0,0.0,06/18/2024 08:11 AM,2,7,0
1,a3a93622-a135-11e9-9cda-0a87ae2ba916,8,7,0,1,0,1,0,0.0,0.0,06/18/2024 08:11 AM,7,0,0
1,a3b2767f-a135-11e9-9cda-0a87ae2ba916,9,2,0,1,0,1,0,0.0,0.0,06/18/2024 08:11 AM,2,0,0
1,a3a99346-a135-11e9-9cda-0a87ae2ba916,3,8,5,1,0,1,0,0.0,0.0,06/18/2024 08:11 AM,3,5,0
1,a3b443ce-a135-11e9-9cda-0a87ae2ba916,2,4,3,1,0,1,1,3.0,0.0,06/18/2024 08:11 AM,1,3,0
1,a3a3cbac-a135-11e9-9cda-0a87ae2ba916,8,14,1,1,0,1,1,0.0,0.0,06/18/2024 08:11 AM,13,1,0
1,a3a6002c-a135-11e9-9cda-0a87ae2ba916,5,9,4,1,0,1,0,1.0,0.0,06/18/2024 08:11 AM,5,4,1
1,a3aa2078-a135-11e9-9cda-0a87ae2ba916,2,12,3,1,0,1,1,0.0,0.0,06/18/2024 08:11 AM,9,3,0
1,a3ace51b-a135-11e9-9cda-0a87ae2ba916,5,6,0,1,0,1,0,0.0,0.0,06/18/2024 08:11 AM,6,0,0
1,1927730149429352986,6,9,1,1,0,1,0,0.0,0.0,06/18/2024 08:12 AM,8,1,0
1,1957713517347478034,21,2,1,1,0,1,0,0.0,0.0,06/18/2024 08:12 AM,1,1,0
1,a3aa1b5b-a135-11e9-9cda-0a87ae2ba916,7,8,0,1,0,1,0,1.0,0.0,06/18/2024 08:12 AM,8,0,0
1,1879439147302566804,9,2,2,1,0,1,0,0.0,0.0,06/18/2024 08:12 AM,0,2,0
1,a3a9df3a-a135-11e9-9cda-0a87ae2ba916,1,11,7,1,0,1,0,2.0,1.0,06/18/2024 08:12 AM,4,7,2
1,a3a840a6-a135-11e9-9cda-0a87ae2ba916,6,14,7,1,0,1,1,2.0,0.0,06/18/2024 08:12 AM,7,7,0
1,a3b2a4ca-a135-11e9-9cda-0a87ae2ba916,10,1,0,1,0,1,0,0.0,0.0,06/18/2024 08:12 AM,1,0,0
1,a3b44eba-a135-11e9-9cda-0a87ae2ba916,1,6,1,1,0,1,0,0.0,0.0,06/18/2024 08:12 AM,5,1,0
1,a3a9b6e9-a135-11e9-9cda-0a87ae2ba916,4,8,0,1,0,1,2,1.0,0.0,06/18/2024 08:12 AM,8,0,1
1,a3ad37c2-a135-11e9-9cda-0a87ae2ba916,2,9,6,1,0,1,0,0.0,0.0,06/18/2024 08:12 AM,3,6,0
1,a3aae870-a135-11e9-9cda-0a87ae2ba916,5,8,2,1,0,1,1,1.0,0.0,06/18/2024 08:12 AM,6,2,0
1,a3ac88db-a135-11e9-9cda-0a87ae2ba916,2,8,6,1,0,1,1,0.0,0.0,06/18/2024 08:12 AM,2,6,0
1,a3af7c0e-a135-11e9-9cda-0a87ae2ba916,2,9,1,1,0,1,4,0.0,0.0,06/18/2024 08:12 AM,8,1,0
1,1929516918167933834,1,8,4,1,0,1,2,0.0,0.0,06/18/2024 08:12 AM,4,4,0
1,a3a7f5ea-a135-11e9-9cda-0a87ae2ba916,14,2,0,1,0,1,0,3.0,0.0,06/18/2024 08:12 AM,2,0,0
1,a3a940a2-a135-11e9-9cda-0a87ae2ba916,14,1,1,1,0,1,1,0.0,0.0,06/18/2024 08:12 AM,0,0,0
1,a3b11ea4-a135-11e9-9cda-0a87ae2ba916,1,7,3,1,0,1,3,0.0,0.0,06/18/2024 08:12 AM,4,3,0
1,a3a634dd-a135-11e9-9cda-0a87ae2ba916,9,5,1,1,0,1,1,0.0,0.0,06/18/2024 08:12 AM,4,1,0
1,a3a83181-a135-11e9-9cda-0a87ae2ba916,8,7,0,1,0,1,0,0.0,0.0,06/18/2024 08:12 AM,7,0,0
1,1885794833713023406,4,7,1,1,0,1,1,0.0,0.0,06/18/2024 08:12 AM,6,1,0
1,1838613156025764214,5,8,2,1,0,1,2,0.0,0.0,06/18/2024 08:12 AM,6,2,0
1,1939575808945160592,3,9,2,1,0,1,3,0.0,0.0,06/18/2024 08:12 AM,7,2,0
1,a3a60f7e-a135-11e9-9cda-0a87ae2ba916,13,4,0,1,0,1,6,0.0,0.0,06/18/2024 08:12 AM,4,0,0
1,a3ac54af-a135-11e9-9cda-0a87ae2ba916,11,11,0,1,0,1,0,0.0,0.0,06/18/2024 08:12 AM,11,0,0
1,a3aa4a58-a135-11e9-9cda-0a87ae2ba916,7,11,1,1,0,1,1,0.0,0.0,06/18/2024 08:12 AM,10,1,0
1,a3a5bf01-a135-11e9-9cda-0a87ae2ba916,13,6,4,1,0,1,4,0.0,0.0,06/18/2024 08:12 AM,2,4,0
1,a3a4a71e-a135-11e9-9cda-0a87ae2ba916,11,8,6,1,0,1,2,2.0,0.0,06/18/2024 08:12 AM,2,6,1
1,a3a6d884-a135-11e9-9cda-0a87ae2ba916,13,1,1,1,0,1,1,0.0,0.0,06/18/2024 08:12 AM,0,1,0
1,1939172360789937026,3,11,5,1,0,1,1,0.0,0.0,06/18/2024 08:12 AM,6,5,0
1,1934288340856818638,5,9,0,1,0,1,1,0.0,0.0,06/18/2024 08:12 AM,9,0,0
1,a3aaed81-a135-11e9-9cda-0a87ae2ba916,17,1,0,1,0,1,1,0.0,0.0,06/18/2024 08:12 AM,1,0,0
1,1952605912741636714,11,3,0,1,0,1,1,0.0,0.0,06/18/2024 08:12 AM,3,0,0
1,1934289745311123692,3,6,2,1,0,1,6,0.0,0.0,06/18/2024 08:12 AM,4,2,0
1,a3a87b3f-a135-11e9-9cda-0a87ae2ba916,7,8,5,1,0,1,0,0.0,0.0,06/18/2024 08:12 AM,3,5,0
1,a3b029be-a135-11e9-9cda-0a87ae2ba916,11,5,0,1,0,1,3,0.0,0.0,06/18/2024 08:12 AM,5,0,0
1,a3aafccb-a135-11e9-9cda-0a87ae2ba916,5,9,0,1,0,1,0,1.0,0.0,06/18/2024 08:12 AM,9,0,0
1,a3aded13-a135-11e9-9cda-0a87ae2ba916,4,6,3,1,0,1,1,0.0,0.0,06/18/2024 08:12 AM,3,3,0
1,a3a3c696-a135-11e9-9cda-0a87ae2ba916,6,3,0,1,0,1,6,0.0,0.0,06/18/2024 08:12 AM,3,0,0
1,a3b0e141-a135-11e9-9cda-0a87ae2ba916,6,2,0,1,0,1,3,0.0,0.0,06/18/2024 08:12 AM,2,0,0
1,a3a9f256-a135-11e9-9cda-0a87ae2ba916,9,6,0,1,0,1,4,0.0,0.0,06/18/2024 08:12 AM,6,0,0
1,a3a9cafa-a135-11e9-9cda-0a87ae2ba916,3,12,3,1,0,1,0,0.0,0.0,06/18/2024 08:12 AM,9,3,0
1,a3b0b291-a135-11e9-9cda-0a87ae2ba916,6,7,1,1,0,1,1,1.0,0.0,06/18/2024 08:12 AM,6,1,0
1,a3affb22-a135-11e9-9cda-0a87ae2ba916,2,14,4,1,0,1,1,2.0,0.0,06/18/2024 08:12 AM,10,4,0
1,a3aff10c-a135-11e9-9cda-0a87ae2ba916,2,7,2,1,0,1,2,0.0,0.0,06/18/2024 08:12 AM,5,2,0
1,a3aa640c-a135-11e9-9cda-0a87ae2ba916,7,12,4,1,0,1,0,0.0,0.0,06/18/2024 08:12 AM,8,4,0
1,4c57c316-82a8-4b9d-a16c-ae7922a2057a,2,13,4,1,0,1,0,0.0,0.0,06/18/2024 08:12 AM,9,4,0
1,a3a60a65-a135-11e9-9cda-0a87ae2ba916,10,1,1,1,0,1,7,1.0,0.0,06/18/2024 08:12 AM,0,1,1
1,1887668523852444498,8,3,3,1,0,1,0,0.0,0.0,06/18/2024 08:12 AM,0,3,0
1,a3a42fa7-a135-11e9-9cda-0a87ae2ba916,0,11,6,1,0,1,0,3.0,1.0,06/18/2024 08:12 AM,5,6,3
1,a3b1e065-a135-11e9-9cda-0a87ae2ba916,4,5,2,1,0,1,0,2.0,0.0,06/18/2024 08:12 AM,3,2,2
1,62cb5f1d-7dcb-4fe1-849f-d928288d73b9,7,6,0,1,0,1,2,0.0,0.0,06/18/2024 08:12 AM,6,0,0
1,a3b3a0c8-a135-11e9-9cda-0a87ae2ba916,5,4,0,1,0,1,1,1.0,0.0,06/18/2024 08:12 AM,4,0,1
1,a3ad09b2-a135-11e9-9cda-0a87ae2ba916,4,7,1,1,0,1,0,0.0,0.0,06/18/2024 08:12 AM,6,1,0
1,a3a790cc-a135-11e9-9cda-0a87ae2ba916,12,10,1,1,0,1,8,1.0,0.0,06/18/2024 08:12 AM,9,1,1
1,a3a945c0-a135-11e9-9cda-0a87ae2ba916,21,16,3,1,0,1,1,1.0,1.0,06/18/2024 08:12 AM,13,3,0
1,03a1610c-3ba0-4b85-b512-bc26791cb7ee,6,9,1,1,0,1,0,0.0,0.0,06/18/2024 08:12 AM,8,1,0
1,a3a44476-a135-11e9-9cda-0a87ae2ba916,20,3,0,1,0,1,0,0.0,0.0,06/18/2024 08:12 AM,3,0,0
1,ee925757-31ce-41ad-9bb7-73b1bb363616,6,4,3,1,0,1,1,0.0,0.0,06/18/2024 08:12 AM,1,3,0
1,a3b0b801-a135-11e9-9cda-0a87ae2ba916,2,6,2,1,0,1,3,0.0,0.0,06/18/2024 08:12 AM,4,2,0
1,1890602768178733256,10,3,2,1,0,1,2,0.0,0.0,06/18/2024 08:12 AM,1,2,0
1,a3ac6f28-a135-11e9-9cda-0a87ae2ba916,5,12,0,1,0,1,1,1.0,0.0,06/18/2024 08:12 AM,12,0,1
1,a3ae737f-a135-11e9-9cda-0a87ae2ba916,6,6,0,1,0,1,3,0.0,0.0,06/18/2024 08:12 AM,6,0,0
1,a3a80a1e-a135-11e9-9cda-0a87ae2ba916,1,18,1,1,0,1,3,1.0,0.0,06/18/2024 08:12 AM,17,1,0
1,a3afdcbf-a135-11e9-9cda-0a87ae2ba916,3,12,4,1,0,1,0,1.0,0.0,06/18/2024 08:12 AM,8,4,0
1,a3a767b1-a135-11e9-9cda-0a87ae2ba916,8,6,0,1,0,1,1,0.0,0.0,06/18/2024 08:12 AM,6,0,0
1,a3ae687f-a135-11e9-9cda-0a87ae2ba916,7,4,1,1,0,1,0,0.0,0.0,06/18/2024 08:12 AM,3,1,0
1,a3ad8fd9-a135-11e9-9cda-0a87ae2ba916,7,7,2,1,0,1,4,1.0,0.0,06/18/2024 08:12 AM,5,2,0
1,a3a4739d-a135-11e9-9cda-0a87ae2ba916,21,2,0,1,0,1,1,0.0,2.0,06/18/2024 08:12 AM,2,0,0
1,a3b1e588-a135-11e9-9cda-0a87ae2ba916,6,2,1,1,0,1,2,1.0,0.0,06/18/2024 08:12 AM,1,1,1
1,1859718111300847802,4,9,4,1,0,1,2,0.0,0.0,06/18/2024 08:12 AM,5,4,0
1,a3b4590f-a135-11e9-9cda-0a87ae2ba916,7,4,0,1,0,1,0,0.0,0.0,06/18/2024 08:12 AM,4,0,0
1,a3b2ec43-a135-11e9-9cda-0a87ae2ba916,0,8,1,1,0,1,7,0.0,0.0,06/18/2024 08:12 AM,7,1,0
1,a3a9984a-a135-11e9-9cda-0a87ae2ba916,8,1,0,1,0,1,2,0.0,0.0,06/18/2024 08:12 AM,1,0,0
1,a3b01578-a135-11e9-9cda-0a87ae2ba916,11,8,3,1,0,1,0,0.0,0.0,06/18/2024 08:12 AM,5,3,0
1,a3afaef3-a135-11e9-9cda-0a87ae2ba916,3,14,8,1,0,1,2,0.0,0.0,06/18/2024 08:12 AM,6,8,0
1,a3b1050d-a135-11e9-9cda-0a87ae2ba916,2,10,1,1,0,1,3,0.0,0.0,06/18/2024 08:12 AM,9,1,0
1,a3b4963f-a135-11e9-9cda-0a87ae2ba916,8,5,3,1,0,1,2,0.0,0.0,06/18/2024 08:12 AM,2,3,0
1,a3a5428e-a135-11e9-9cda-0a87ae2ba916,4,17,5,1,0,1,4,9.0,1.0,06/18/2024 08:12 AM,12,5,9
1,b09832de-1c8e-4b92-bd72-bd98dc80b92c,4,10,5,1,0,1,1,0.0,0.0,06/18/2024 08:12 AM,5,5,0
1,a3b2af02-a135-11e9-9cda-0a87ae2ba916,2,9,0,1,0,1,0,0.0,0.0,06/18/2024 08:12 AM,9,0,0
1,a3adaf6b-a135-11e9-9cda-0a87ae2ba916,0,14,6,1,0,1,5,0.0,0.0,06/18/2024 08:12 AM,8,6,0
1,a3ac1bc9-a135-11e9-9cda-0a87ae2ba916,6,5,1,1,0,1,2,2.0,0.0,06/18/2024 08:12 AM,4,1,0
1,a3acf4eb-a135-11e9-9cda-0a87ae2ba916,9,2,0,1,0,1,0,0.0,0.0,06/18/2024 08:12 AM,2,0,0
1,1870193411073343610,1,13,11,1,0,1,0,1.0,0.0,06/18/2024 08:12 AM,2,11,0
1,1932088872431302840,6,7,0,1,0,1,2,0.0,0.0,06/18/2024 08:12 AM,7,0,0
1,a3a93b6d-a135-11e9-9cda-0a87ae2ba916,6,8,0,1,0,1,1,0.0,0.0,06/18/2024 08:12 AM,8,0,0
1,a3a83698-a135-11e9-9cda-0a87ae2ba916,9,9,1,1,0,1,1,0.0,0.0,06/18/2024 08:12 AM,8,1,0
1,a3a79fdc-a135-11e9-9cda-0a87ae2ba916,26,5,1,1,0,1,0,0.0,1.0,06/18/2024 08:12 AM,3,1,0
1,a3b0ccad-a135-11e9-9cda-0a87ae2ba916,2,7,1,1,0,1,2,0.0,0.0,06/18/2024 08:13 AM,6,1,0
1,a3b123c5-a135-11e9-9cda-0a87ae2ba916,9,2,2,1,0,1,0,0.0,0.0,06/18/2024 08:13 AM,0,2,0
1,a3a555e8-a135-11e9-9cda-0a87ae2ba916,6,9,1,1,0,1,0,0.0,0.0,06/18/2024 08:12 AM,8,1,0
1,a3b4a05c-a135-11e9-9cda-0a87ae2ba916,0,9,1,1,0,1,6,0.0,0.0,06/18/2024 08:12 AM,8,1,0
1,a3af3bac-a135-11e9-9cda-0a87ae2ba916,0,15,3,1,0,1,0,0.0,0.0,06/18/2024 08:12 AM,12,3,0
1,a3a6ed98-a135-11e9-9cda-0a87ae2ba916,1,12,1,1,0,1,2,0.0,0.0,06/18/2024 08:12 AM,11,1,0
1,a3a58495-a135-11e9-9cda-0a87ae2ba916,22,2,0,1,0,1,2,1.0,0.0,06/18/2024 08:12 AM,2,0,0
1,a3a739e4-a135-11e9-9cda-0a87ae2ba916,24,1,1,1,0,1,6,0.0,0.0,06/18/2024 08:12 AM,0,1,0
1,a3b36d8a-a135-11e9-9cda-0a87ae2ba916,20,14,6,1,0,1,5,1.0,2.0,06/18/2024 08:12 AM,8,7,1
1,a3b23263-a135-11e9-9cda-0a87ae2ba916,6,4,0,1,0,1,1,0.0,0.0,06/18/2024 08:12 AM,4,0,0
1,a3a74e60-a135-11e9-9cda-0a87ae2ba916,17,11,3,1,0,1,3,0.0,0.0,06/18/2024 08:13 AM,8,3,0
1,a3aab0b6-a135-11e9-9cda-0a87ae2ba916,9,5,3,1,0,1,4,1.0,0.0,06/18/2024 08:13 AM,2,3,0
1,a3a71b0a-a135-11e9-9cda-0a87ae2ba916,3,7,1,1,0,1,0,1.0,0.0,06/18/2024 08:13 AM,6,1,1
1,a3a715ce-a135-11e9-9cda-0a87ae2ba916,8,4,1,1,0,1,2,0.0,0.0,06/18/2024 08:13 AM,3,1,0
1,1859717767703464460,2,12,5,1,0,1,1,0.0,0.0,06/18/2024 08:13 AM,7,5,0
1,1861593053874186306,6,8,0,1,0,1,1,0.0,0.0,06/18/2024 08:13 AM,8,0,0
1,a5a5cb39-a6ee-45bc-96a0-6455ae111bad,11,4,1,1,0,1,0,0.0,0.0,06/18/2024 08:13 AM,3,1,0
1,1936582699682930930,4,9,7,1,0,1,2,0.0,0.0,06/18/2024 08:13 AM,2,7,0
1,a3a7b41d-a135-11e9-9cda-0a87ae2ba916,4,10,3,1,0,1,1,0.0,0.0,06/18/2024 08:13 AM,7,3,0
1,1872721938125427506,5,7,3,1,0,1,3,0.0,0.0,06/18/2024 08:13 AM,4,3,0
1,1879439877447006990,7,3,0,1,0,1,5,0.0,0.0,06/18/2024 08:13 AM,3,0,0
1,a3a5fb0d-a135-11e9-9cda-0a87ae2ba916,9,5,0,1,0,1,0,0.0,0.0,06/18/2024 08:13 AM,5,0,0
1,a3a40088-a135-11e9-9cda-0a87ae2ba916,14,3,0,1,0,1,6,0.0,0.0,06/18/2024 08:13 AM,3,0,0
1,a3b1330c-a135-11e9-9cda-0a87ae2ba916,4,7,7,1,0,1,0,0.0,0.0,06/18/2024 08:13 AM,0,7,0
1,cec28069-2a36-48e1-bcec-2364b44834c4,7,7,1,1,0,1,1,0.0,0.0,06/18/2024 08:13 AM,6,1,0
1,a3aaa17b-a135-11e9-9cda-0a87ae2ba916,2,17,1,1,0,1,0,0.0,0.0,06/18/2024 08:13 AM,16,1,0
1,1931403472863201974,3,10,0,1,0,1,1,1.0,0.0,06/18/2024 08:13 AM,10,0,0
1,a3afa9dc-a135-11e9-9cda-0a87ae2ba916,6,6,6,1,0,1,1,2.0,0.0,06/18/2024 08:13 AM,0,6,0
1,a3a5c96f-a135-11e9-9cda-0a87ae2ba916,6,7,0,1,0,1,1,2.0,0.0,06/18/2024 08:13 AM,7,0,0
1,a3ac213b-a135-11e9-9cda-0a87ae2ba916,5,10,0,1,0,1,0,0.0,0.0,06/18/2024 08:13 AM,10,0,0
1,bbb67562-1f82-4dfa-a532-231ddc35444e,1,14,6,1,0,1,0,0.0,0.0,06/18/2024 08:13 AM,8,6,0
1,a3ae6e48-a135-11e9-9cda-0a87ae2ba916,0,11,11,1,0,1,0,0.0,0.0,06/18/2024 08:13 AM,0,11,0
1,a3acb6f3-a135-11e9-9cda-0a87ae2ba916,4,11,4,1,0,1,0,0.0,0.0,06/18/2024 08:13 AM,7,4,0
1,1936552997477483122,4,7,0,1,0,1,4,0.0,0.0,06/18/2024 08:13 AM,7,0,0
1,a3adb48a-a135-11e9-9cda-0a87ae2ba916,1,9,2,1,0,1,0,1.0,0.0,06/18/2024 08:13 AM,7,2,0
1,1869786699581020630,7,5,1,1,0,1,3,0.0,0.0,06/18/2024 08:13 AM,4,1,0
1,a3a95669-a135-11e9-9cda-0a87ae2ba916,0,21,1,1,0,1,4,2.0,0.0,06/18/2024 08:13 AM,20,1,0
1,a3a4881d-a135-11e9-9cda-0a87ae2ba916,0,12,1,1,0,1,1,1.0,1.0,06/18/2024 08:13 AM,11,1,1
1,a3a95b7a-a135-11e9-9cda-0a87ae2ba916,7,8,1,1,0,1,0,0.0,0.0,06/18/2024 08:13 AM,7,1,0
1,1955583912707186772,7,7,2,1,0,1,1,0.0,0.0,06/18/2024 08:13 AM,5,2,0
1,1872723419889143870,3,10,1,1,0,1,2,0.0,0.0,06/18/2024 08:13 AM,9,1,0
1,1942539875938640858,14,1,1,1,0,1,0,0.0,0.0,06/18/2024 08:13 AM,0,1,0
1,1859027847673133268,4,6,4,1,0,1,1,0.0,0.0,06/18/2024 08:13 AM,2,4,0
1,a3b2f15e-a135-11e9-9cda-0a87ae2ba916,0,14,2,1,0,1,1,0.0,0.0,06/18/2024 08:13 AM,12,2,0
1,a3adc3f6-a135-11e9-9cda-0a87ae2ba916,2,9,4,1,0,1,0,0.0,0.0,06/18/2024 08:13 AM,5,4,0
1,a3afebff-a135-11e9-9cda-0a87ae2ba916,5,6,4,1,0,1,0,0.0,0.0,06/18/2024 08:13 AM,1,4,0
1,a3a845b0-a135-11e9-9cda-0a87ae2ba916,11,10,0,1,0,1,1,1.0,0.0,06/18/2024 08:13 AM,10,0,0
1,a3a98e37-a135-11e9-9cda-0a87ae2ba916,9,0,0,1,0,1,2,0.0,0.0,06/18/2024 08:13 AM,0,0,0
1,a3a3fb5d-a135-11e9-9cda-0a87ae2ba916,12,2,0,1,0,1,0,1.0,1.0,06/18/2024 08:13 AM,2,0,0
1,a3aaf2ac-a135-11e9-9cda-0a87ae2ba916,3,8,0,1,0,1,3,0.0,0.0,06/18/2024 08:13 AM,8,0,0
1,a3b2fbb6-a135-11e9-9cda-0a87ae2ba916,5,3,1,1,0,1,7,0.0,0.0,06/18/2024 08:13 AM,2,1,0
1,a3a7775b-a135-11e9-9cda-0a87ae2ba916,20,6,3,1,0,1,1,0.0,0.0,06/18/2024 08:13 AM,2,3,0
1,a3a9fc75-a135-11e9-9cda-0a87ae2ba916,11,7,0,1,0,1,1,0.0,0.0,06/18/2024 08:13 AM,7,0,0
1,a3a7e69e-a135-11e9-9cda-0a87ae2ba916,7,1,1,1,0,1,2,1.0,0.0,06/18/2024 08:13 AM,0,1,0
1,1806753657092916066,0,1,1,1,0,1,1,0.0,0.0,05/01/2023 03:06 PM,0,1,0
1,1674190368396028570,0,4,4,1,0,1,0,0.0,0.0,01/22/2023 09:45 PM,0,4,0
1,1575949528158434034,9,0,0,1,0,1,0,0.0,,01/22/2023 09:44 PM,0,0,0
1,1674190334036290134,0,1,1,1,0,1,2,1.0,0.0,01/22/2023 09:46 PM,0,1,0
1,1806749752967643692,2,0,0,1,0,1,0,,,05/01/2023 02:51 PM,0,0,0
1,1677249819534170180,1,0,0,1,0,1,0,,,01/22/2023 09:45 PM,0,0,0
1,1677249793764366376,1,0,0,1,0,1,0,,,01/22/2023 09:44 PM,0,0,0
1,1594046405283107528,8,0,0,1,0,1,1,0.0,,01/22/2023 09:44 PM,0,0,0
1,1674190226662107536,1,0,0,1,0,1,0,0.0,,01/22/2023 09:47 PM,0,0,0
1,1677249858188875900,1,0,0,1,0,1,0,0.0,,01/22/2023 09:45 PM,0,0,0
1,1674190527309818774,0,0,0,1,0,1,1,0.0,,01/22/2023 09:47 PM,0,0,0
1,1806749718607905164,2,0,0,1,0,1,0,,,05/01/2023 02:51 PM,0,0,0
1,1695780074116615022,10,0,0,1,0,1,0,0.0,,01/22/2023 09:45 PM,0,0,0
1,1715846718385914742,2,0,0,1,0,1,0,,,01/22/2023 09:45 PM,0,0,0
1,1677249875368745118,1,0,0,1,0,1,0,,,01/22/2023 09:46 PM,0,0,0
1,1683527933580884970,1,0,0,1,0,1,0,1.0,0.0,01/22/2023 09:44 PM,0,0,0
1,1575949515273532128,1,7,7,1,0,1,0,2.0,0.0,01/22/2023 09:47 PM,0,7,0
1,1673852313397164648,1,1,1,1,0,1,0,0.0,0.0,01/22/2023 09:44 PM,0,1,0
1,1674190664748772496,1,0,0,1,0,1,0,,,01/22/2023 09:45 PM,0,0,0
1,1806749731492807130,0,3,3,1,0,1,0,0.0,0.0,05/01/2023 02:51 PM,0,3,0
1,1582242289567815212,2,5,5,1,0,1,0,0.0,0.0,01/22/2023 09:47 PM,0,5,0
1,1806749718607905152,2,0,0,1,0,1,0,,,05/01/2023 02:51 PM,0,0,0
1,1806753652797948736,0,3,3,1,0,1,0,0.0,0.0,05/01/2023 03:06 PM,0,3,0
1,1674190342626224740,1,0,0,1,0,1,0,,,01/22/2023 09:44 PM,0,0,0
1,1806749748672676376,2,0,0,1,0,1,0,,,05/01/2023 02:51 PM,0,0,0
1,1806749727197839826,3,1,1,1,0,1,0,0.0,0.0,05/01/2023 02:51 PM,0,1,0
1,1827474409018810992,3,0,0,1,0,1,0,,,06/26/2023 11:14 AM,0,0,0
1,1582242319632586320,1,5,5,1,0,1,0,0.0,0.0,01/22/2023 09:45 PM,0,5,0
1,1674190299676551700,1,0,0,1,0,1,0,,,01/22/2023 09:45 PM,0,0,0
1,1594046370923369112,8,0,0,1,0,1,0,2.0,0.0,04/26/2023 08:05 PM,0,0,0
1,1715846705501012842,1,0,0,1,0,1,0,0.0,,01/22/2023 09:46 PM,0,0,0
1,1674190398460799668,1,0,0,1,0,1,0,0.0,,01/22/2023 09:45 PM,0,0,0
1,1674190501540014956,2,0,0,1,0,1,1,,,01/22/2023 09:44 PM,0,0,0
1,1674190660453805190,2,0,0,1,0,1,0,,,01/22/2023 09:46 PM,0,0,0
1,1806753652797948744,1,0,0,1,0,1,1,0.0,0.0,05/01/2023 03:06 PM,0,0,0
1,1677249879663712418,1,0,0,1,0,1,0,,,01/22/2023 09:45 PM,0,0,0
1,1594046465420805300,8,1,1,1,0,1,0,0.0,0.0,01/22/2023 09:47 PM,0,1,0
1,1674190527309818776,1,0,0,1,0,1,0,,,01/22/2023 09:47 PM,0,0,0
1,1674190419935636184,1,0,0,1,0,1,0,,,01/22/2023 09:45 PM,0,0,0
1,1674190441410472714,1,0,0,1,0,1,0,0.0,,01/22/2023 09:45 PM,0,0,0
1,1695776990330095648,1,2,2,1,0,1,0,0.0,0.0,01/22/2023 09:45 PM,0,2,0
1,1806753644208014082,2,0,0,1,0,1,0,,,05/01/2023 03:06 PM,0,0,0
1,1674190647568903270,0,1,1,1,0,1,0,0.0,0.0,01/22/2023 09:44 PM,0,1,0
1,1563698679731458032,0,8,8,1,0,1,1,0.0,0.0,01/22/2023 09:46 PM,0,8,0
1,1674190278201715172,0,1,1,1,0,1,0,0.0,0.0,01/22/2023 09:46 PM,0,1,0
1,1674190273906747872,1,0,0,1,0,1,0,,,01/22/2023 09:45 PM,0,0,0
1,1674190600324262928,4,0,0,1,0,1,0,0.0,,01/22/2023 09:44 PM,0,0,0
1,1683527974474827792,1,0,0,1,0,1,0,0.0,,01/22/2023 09:45 PM,0,0,0
1,1674190419935636190,1,0,0,1,0,1,0,1.0,0.0,01/22/2023 09:46 PM,0,0,0
1,1806749757262611026,4,0,0,1,0,1,0,,,05/01/2023 02:51 PM,0,0,0
1,1674190660453805188,2,0,0,1,0,1,0,,,01/22/2023 09:44 PM,0,0,0
1,1674190153647663368,1,0,0,1,0,1,0,,,01/22/2023 09:47 PM,0,0,0
1,1674190428525570800,1,0,0,1,0,1,0,1.0,0.0,01/22/2023 09:45 PM,0,0,0
1,1674190402755766966,1,0,0,1,0,1,0,0.0,,01/22/2023 09:44 PM,0,0,0
1,1674190338331257442,1,0,0,1,0,1,0,,,01/22/2023 09:46 PM,0,0,0
1,1674190145057728760,0,0,0,1,0,1,1,,,01/22/2023 09:46 PM,0,0,0
1,1674190157942630676,2,0,0,1,0,1,0,0.0,,01/22/2023 09:45 PM,0,0,0
1,1674190359806093956,0,1,1,1,0,1,0,0.0,0.0,01/22/2023 09:45 PM,0,1,0
1,1674190411345701580,2,0,0,1,0,1,0,,,01/22/2023 09:45 PM,0,0,0
1,1695776950890011384,2,0,0,1,0,1,0,0.0,,01/22/2023 09:44 PM,0,0,0
1,1674190269611780566,1,0,0,1,0,1,0,0.0,,01/22/2023 09:46 PM,0,0,0
1,1674190574554459120,1,0,0,1,0,1,0,0.0,,01/22/2023 09:47 PM,0,0,0
1,1677249845303973994,2,0,0,1,0,1,0,,,01/22/2023 09:46 PM,0,0,0
1,1436495100903691938,3,3,3,1,0,1,0,1.0,0.0,01/22/2023 09:45 PM,0,3,0
1,1806753657092916058,1,0,0,1,0,1,1,0.0,0.0,05/01/2023 03:06 PM,0,0,0
1,1806749722902872496,3,0,0,1,0,1,0,,,05/01/2023 02:51 PM,0,0,0
1,1715846691563848032,1,0,0,1,0,1,0,0.0,,01/22/2023 09:44 PM,0,0,0
1,1674190651863870574,2,0,0,1,0,1,0,,,01/22/2023 09:44 PM,0,0,0
1,1571105042230683636,6,1,1,1,0,1,2,0.0,0.0,01/22/2023 09:44 PM,0,1,0
1,1683527950760754174,1,0,0,1,0,1,0,,,01/22/2023 09:44 PM,0,0,0
1,1594046456822715150,7,2,2,1,0,1,0,0.0,0.0,01/22/2023 09:46 PM,0,2,0
1,1674190209482238322,0,1,1,1,0,1,1,0.0,0.0,01/22/2023 09:47 PM,0,1,0
1,1715823786785102364,1,0,0,1,0,1,0,,,01/22/2023 09:46 PM,0,0,0
1,1674190140762761456,1,0,0,1,0,1,0,0.0,,01/22/2023 09:44 PM,0,0,0
1,1674190411345701574,0,1,1,1,0,1,0,0.0,0.0,01/22/2023 09:47 PM,0,1,0
1,1806749722902872490,3,0,0,1,0,1,0,,,05/09/2023 11:43 AM,0,0,0
1,1674190424230603490,2,0,0,1,0,1,0,0.0,,01/22/2023 09:46 PM,0,0,0
1,1806749722902872480,2,0,0,1,0,1,0,,,05/01/2023 02:51 PM,0,0,0
1,1674190591734328324,2,0,0,1,0,1,0,,,01/22/2023 09:46 PM,0,0,0
1,1715846701206045544,2,0,0,1,0,1,0,0.0,,01/22/2023 09:46 PM,0,0,0
1,1806753665682850706,2,0,0,1,0,1,0,,,05/01/2023 03:06 PM,0,0,0
1,1561012891600925250,2,6,6,1,0,1,0,0.0,0.0,01/22/2023 09:46 PM,0,6,0
1,1674190488655113044,1,0,0,1,0,1,0,0.0,,01/22/2023 09:47 PM,0,0,0
1,1677249793764366370,1,0,0,1,0,1,0,0.0,,01/22/2023 09:44 PM,0,0,0
1,1674190488655113048,1,0,0,1,0,1,1,0.0,,05/08/2023 09:39 AM,0,0,0
1,1594046409578074830,9,0,0,1,0,1,0,0.0,,01/22/2023 09:44 PM,0,0,0
1,1674190299676551698,1,0,0,1,0,1,0,,,01/22/2023 09:46 PM,0,0,0
1,1571105068000485406,2,4,4,1,0,1,2,0.0,0.0,01/22/2023 09:45 PM,0,4,0
1,1806749761557578336,2,0,0,1,0,1,0,,,05/01/2023 02:51 PM,0,0,0
1,1674190269611780562,1,0,0,1,0,1,0,,,01/22/2023 09:45 PM,0,0,0
1,1563698718386161684,7,1,1,1,0,1,1,0.0,0.0,01/22/2023 09:46 PM,0,1,0
1,1674190162237597976,1,0,0,1,0,1,0,0.0,,01/22/2023 09:46 PM,0,0,0
1,1677249823829137482,1,0,0,1,0,1,0,,,01/22/2023 09:47 PM,0,0,0
1,1806753648502981408,2,0,0,1,0,1,0,,,05/01/2023 03:06 PM,0,0,0
1,1674190613209164836,3,0,0,1,0,1,0,0.0,,01/22/2023 09:47 PM,0,0,0
1,1561012887305957948,6,3,3,1,0,1,0,0.0,0.0,01/22/2023 09:45 PM,0,3,0
1,1674190437115505410,1,1,1,1,0,1,0,0.0,0.0,01/22/2023 09:44 PM,0,1,0
1,1674190355511126658,1,0,0,1,0,1,0,,,01/22/2023 09:46 PM,0,0,0
1,1674190145057728764,1,0,0,1,0,1,0,,,01/22/2023 09:45 PM,0,0,0
1,1806753631323112140,2,0,0,1,0,1,0,0.0,,05/01/2023 03:06 PM,0,0,0
1,1674190235252042152,1,0,0,1,0,1,0,0.0,,01/22/2023 09:45 PM,0,0,0
1,1571105042230683640,5,2,2,1,0,1,0,0.0,0.0,01/22/2023 09:45 PM,0,2,0
1,1674190372690995872,2,0,0,1,0,1,0,0.0,,01/22/2023 09:44 PM,0,0,0
1,1674190664748772498,2,0,0,1,0,1,0,,,01/22/2023 09:47 PM,0,0,0
1,1806753639913046782,2,0,0,1,0,1,0,,,05/01/2023 03:06 PM,0,0,0
1,1695777015314520896,1,0,0,1,0,1,0,0.0,,01/22/2023 09:44 PM,0,0,0
1,1806749725872941466,2,0,0,1,0,1,0,,,05/12/2023 09:34 AM,0,0,0
1,1521690221159885714,1,4,4,1,0,1,3,0.0,1.0,01/22/2023 09:45 PM,0,4,0
1,1594046400988140228,2,7,7,1,0,1,0,0.0,0.0,01/22/2023 09:46 PM,0,7,0
1,1674190200892303712,1,0,0,1,0,1,0,0.0,,01/22/2023 09:44 PM,0,0,0
1,1674190596029295630,2,0,0,1,0,1,0,,,01/22/2023 09:45 PM,0,0,0
1,1674190282496682476,2,0,0,1,0,1,0,0.0,,01/22/2023 09:44 PM,0,0,0
1,1563698705501259788,3,3,3,1,0,1,2,0.0,0.0,01/22/2023 09:46 PM,0,3,0
1,1673852317692131950,1,0,0,1,0,1,0,0.0,,01/22/2023 09:45 PM,0,0,0
1,1677249849598941300,1,0,0,1,0,1,0,,,01/22/2023 09:45 PM,0,0,0
1,1683527942170819570,0,2,2,1,0,1,0,0.0,0.0,01/22/2023 09:46 PM,0,2,0
1,1715823822654071770,1,0,0,1,0,1,0,0.0,,01/22/2023 09:45 PM,0,0,0
1,1674190450000407314,2,0,0,1,0,1,0,0.0,,01/22/2023 09:47 PM,0,0,0
1,1677249767994562566,1,0,0,1,0,1,0,0.0,,01/22/2023 09:44 PM,0,0,0
1,1674190467180276532,1,0,0,1,0,1,0,,,01/22/2023 09:46 PM,0,0,0
1,1674190179417467196,0,1,1,1,0,1,0,0.0,0.0,01/22/2023 09:44 PM,0,1,0
1,1674190561669557204,3,0,0,1,0,1,0,,,01/22/2023 09:45 PM,0,0,0
1,1806753657092916062,2,0,0,1,0,1,0,,,05/01/2023 03:06 PM,0,0,0
1,1674190346921192042,1,0,0,1,0,1,0,,,01/22/2023 09:44 PM,0,0,0
1,1677249789469399070,2,0,0,1,0,1,0,0.0,,01/22/2023 09:46 PM,0,0,0
1,1674190450000407316,2,0,0,1,0,1,0,,,05/11/2023 11:06 AM,0,0,0
1,1674190282496682478,2,0,0,1,0,1,0,,,01/22/2023 09:45 PM,0,0,0
1,1695776978415481326,1,0,0,1,0,1,0,,,01/22/2023 09:47 PM,0,0,0
1,1674190626094066746,2,0,0,1,0,1,0,0.0,,01/22/2023 09:45 PM,0,0,0
1,1806753652797948740,2,0,0,1,0,1,0,,,05/01/2023 03:06 PM,0,0,0
1,1594046396693172926,7,2,2,1,0,1,0,0.0,0.0,01/22/2023 09:46 PM,0,2,0
1,1448642179437434486,4,1,1,1,0,1,0,0.0,0.0,01/22/2023 09:47 PM,0,1,0
1,1674190497245047652,1,0,0,1,0,1,0,,,01/22/2023 09:45 PM,0,0,0
1,1436495096608724634,4,0,0,1,0,1,0,0.0,,07/28/2022 03:40 PM,0,0,0
1,1677249772289529864,0,0,0,1,0,1,1,0.0,0.0,01/22/2023 09:45 PM,0,0,0
1,1674190303971519000,1,0,0,1,0,1,0,,,01/22/2023 09:46 PM,0,0,0
1,1806753657092916052,2,0,0,1,0,1,0,,,05/03/2023 04:47 PM,0,0,0
1,1594046448262943690,4,1,1,1,0,1,4,0.0,0.0,01/22/2023 09:44 PM,0,1,0
1,1683527967940622362,1,0,0,1,0,1,0,0.0,,01/22/2023 09:45 PM,0,0,0
1,1594041781399920506,4,4,4,1,0,1,1,0.0,0.0,01/22/2023 09:44 PM,0,4,0
1,1448642162257565286,1,2,2,1,0,1,0,0.0,0.0,01/22/2023 09:44 PM,0,2,0
1,1715823829734775370,1,0,0,1,0,1,0,0.0,,01/22/2023 09:46 PM,0,0,0
1,1674190475770211136,1,0,0,1,0,1,0,0.0,,01/22/2023 09:46 PM,0,0,0
1,1674190647568903268,1,0,0,1,0,1,0,,,01/22/2023 09:46 PM,0,0,0
1,1594041777104953202,8,1,1,1,0,1,0,0.0,0.0,01/22/2023 09:44 PM,0,1,0
1,1715846717333651852,2,0,0,1,0,1,0,0.0,,01/22/2023 09:47 PM,0,0,0
1,1571105055115583496,0,14,14,1,0,1,0,0.0,0.0,01/22/2023 09:44 PM,0,14,0
1,1806753657092916072,0,2,2,1,0,1,0,0.0,0.0,05/01/2023 03:06 PM,0,2,0
1,1674190432820538108,0,2,2,1,0,1,0,0.0,0.0,01/22/2023 09:46 PM,0,2,0
1,1806753661387883396,2,0,0,1,0,1,0,,,05/01/2023 03:06 PM,0,0,0
1,1806749744377709064,2,0,0,1,0,1,0,,,05/01/2023 02:51 PM,0,0,0
1,1594046388103238324,5,0,0,1,0,1,0,1.0,0.0,01/22/2023 09:46 PM,0,0,0
1,1695777010841019090,1,0,0,1,0,1,1,0.0,,01/22/2023 09:44 PM,0,0,0
1,1806749747347777950,0,3,3,1,0,1,0,0.0,0.0,05/01/2023 02:51 PM,0,3,0
1,1674190381280930478,2,0,0,1,0,1,0,0.0,,01/22/2023 09:45 PM,0,0,0
1,1677249849598941296,2,0,0,1,0,1,0,,,01/22/2023 09:44 PM,0,0,0
1,1683527931525155818,0,3,3,1,0,1,0,0.0,0.0,01/22/2023 09:46 PM,0,3,0
1,1594046379513303716,3,5,5,1,0,1,0,0.0,0.0,01/22/2023 09:44 PM,0,5,0
1,1806749757262611012,2,0,0,1,0,1,1,0.0,0.0,05/01/2023 02:51 PM,0,0,0
1,1806753635618079462,1,1,1,1,0,1,0,0.0,0.0,05/01/2023 03:06 PM,0,1,0
1,1715823796884267962,1,0,0,1,0,1,0,,,01/22/2023 09:46 PM,0,0,0
1,1674190334036290140,1,0,0,1,0,1,0,,,01/22/2023 09:45 PM,0,0,0
1,1674190626094066752,1,0,0,1,0,1,0,,,01/22/2023 09:45 PM,0,0,0
1,1677249883958679718,1,0,0,1,0,1,0,,,01/22/2023 09:45 PM,0,0,0
1,1683527955055720454,1,0,0,1,0,1,0,0.0,,01/22/2023 09:44 PM,0,0,0
1,1806753644208014094,2,0,0,1,0,1,0,,,05/01/2023 03:06 PM,0,0,0
1,1674190604619230230,1,0,0,1,0,1,0,0.0,,01/22/2023 09:44 PM,0,0,0
1,1806753652797948730,2,0,0,1,0,1,0,,,05/01/2023 03:06 PM,0,0,0
1,1674190205187271014,2,0,0,1,0,1,0,0.0,,01/22/2023 09:46 PM,0,0,0
1,1806749748672676378,3,0,0,1,0,1,0,,,05/01/2023 02:51 PM,0,0,0
1,1806749731492807126,4,0,0,1,0,1,0,,,05/01/2023 02:51 PM,0,0,0
1,1674190462885309226,2,0,0,1,0,1,0,,,01/22/2023 09:46 PM,0,0,0
1,1674190321151388222,1,0,0,1,0,1,0,,,01/22/2023 09:46 PM,0,0,0
1,1806753657092916076,2,0,0,1,0,1,0,,,05/04/2023 12:46 PM,0,0,0
1,1806749761557578338,4,0,0,1,0,1,0,,,05/01/2023 02:51 PM,0,0,0
1,1674190621799099446,2,0,0,1,0,1,0,0.0,,01/22/2023 09:45 PM,0,0,0
1,1677249815239202876,1,0,0,1,0,1,0,,,01/22/2023 09:44 PM,0,0,0
1,1677249841009006690,1,0,0,1,0,1,0,,,01/22/2023 09:45 PM,0,0,0
1,1674190261021845960,1,0,0,1,0,1,0,,,01/22/2023 09:46 PM,0,0,0
1,1674190346921192048,1,0,0,1,0,1,0,,,01/22/2023 09:44 PM,0,0,0
1,1594046435347878644,5,3,3,1,0,1,1,0.0,0.0,05/22/2024 03:33 PM,0,3,0
1,1695776948350710232,3,0,0,1,0,1,0,0.0,,01/22/2023 09:44 PM,0,0,0
1,1806753639913046768,0,0,0,1,0,1,2,,,05/01/2023 03:06 PM,0,0,0
1,1575949519568499430,5,3,3,1,0,1,0,0.0,1.0,05/16/2023 09:37 AM,0,3,0
1,1582242285272847904,9,0,0,1,0,1,0,0.0,,01/22/2023 09:44 PM,0,0,0
1,1674190368396028562,1,0,0,1,0,1,1,,,01/22/2023 09:44 PM,0,0,0
1,1715823791080069664,1,0,0,1,0,1,0,,,01/22/2023 09:46 PM,0,0,0
1,1806749731492807128,2,0,0,1,0,1,0,,,05/01/2023 02:51 PM,0,0,0
1,1806749722902872506,4,0,0,1,0,1,0,,,05/01/2023 02:51 PM,0,0,0
1,1806749727197839822,4,0,0,1,0,1,0,,,05/01/2023 02:51 PM,0,0,0
1,1806749757262611036,2,0,0,1,0,1,0,,,05/01/2023 02:51 PM,0,0,0
1,1571105063705518104,1,6,6,1,0,1,2,0.0,0.0,01/22/2023 09:44 PM,0,6,0
1,1674190376985963172,1,0,0,1,0,1,0,,,01/22/2023 09:45 PM,0,0,0
1,1677249845303973996,1,0,0,1,0,1,0,,,01/22/2023 09:44 PM,0,0,0
1,1677249785174431768,2,0,0,1,0,1,0,,,01/22/2023 09:45 PM,0,0,0
1,1674190183712434502,1,0,0,1,0,1,0,,,01/22/2023 09:46 PM,0,0,0
1,1806749748672676392,4,0,0,1,0,1,0,,,05/01/2023 02:51 PM,0,0,0
1,1674190540194720686,1,0,0,1,0,1,0,,,01/22/2023 09:44 PM,0,0,0
1,1715823812554906158,1,0,0,1,0,1,0,,,01/22/2023 09:45 PM,0,0,0
1,1806753648502981402,1,1,1,1,0,1,0,0.0,0.0,05/01/2023 03:06 PM,0,1,0
1,1674190239547009454,1,0,0,1,0,1,0,0.0,,01/22/2023 09:45 PM,0,0,0
1,1594046383808271020,8,1,1,1,0,1,0,0.0,0.0,01/22/2023 09:45 PM,0,1,0
1,1674190359806093958,1,0,0,1,0,1,0,,,01/22/2023 09:46 PM,0,0,0
1,1674190278201715174,2,0,0,1,0,1,0,,,01/22/2023 09:47 PM,0,0,0
1,1594041785694887806,2,3,3,1,0,1,1,0.0,0.0,01/22/2023 09:46 PM,0,3,0
1,1806753664357952126,2,0,0,1,0,1,0,,,05/01/2023 03:06 PM,0,0,0
1,1806753652797948728,1,0,0,1,0,1,1,0.0,0.0,05/04/2023 12:49 PM,0,0,0
1,1695776938005109486,1,0,0,1,0,1,0,0.0,,01/22/2023 09:46 PM,0,0,0
1,1806749731492807144,2,0,0,1,0,1,0,,,05/01/2023 02:51 PM,0,0,0
1,1806749718607905176,4,0,0,1,0,1,0,,,05/01/2023 02:51 PM,0,0,0
1,1683527927230188516,1,0,0,1,0,1,0,1.0,0.0,01/22/2023 09:44 PM,0,0,0
1,1806749731492807142,10,0,0,1,0,1,0,,,05/01/2023 02:51 PM,0,0,0
1,1806753639913046772,2,0,0,1,0,1,0,,,05/01/2023 03:06 PM,0,0,0
1,1674190484360145746,1,0,0,1,0,1,0,0.0,,01/22/2023 09:44 PM,0,0,0
1,1806753631323112128,2,0,0,1,0,1,0,,,05/01/2023 03:06 PM,0,0,0
1,1674190471475243832,1,0,0,1,0,1,0,,,01/22/2023 09:46 PM,0,0,0
1,1674190170827532590,1,0,0,1,0,1,0,0.0,,01/22/2023 09:44 PM,0,0,0
1,1674190140762761460,1,0,0,1,0,1,0,,,01/22/2023 09:45 PM,0,0,0
1,1677249888253647022,1,0,0,1,0,1,0,,,01/22/2023 09:45 PM,0,0,0
1,1806753631323112148,2,0,0,1,0,1,0,,,05/01/2023 03:06 PM,0,0,0
1,1674190634684001356,1,1,1,1,0,1,0,0.0,0.0,01/22/2023 09:46 PM,0,1,0
1,1674190222367140228,1,0,0,1,0,1,1,0.0,0.0,01/22/2023 09:44 PM,0,0,0
1,1674190484360145744,1,1,1,1,0,1,0,0.0,0.0,01/22/2023 09:46 PM,0,1,0
1,1683527937875852272,1,0,0,1,0,1,0,,,01/22/2023 09:47 PM,0,0,0
1,1683527937875852268,1,0,0,1,0,1,0,,,01/22/2023 09:46 PM,0,0,0
1,1715846713038684540,1,0,0,1,0,1,0,0.0,,01/22/2023 09:45 PM,0,0,0
1,1806749718607905156,2,0,0,1,0,1,0,,,05/01/2023 02:51 PM,0,0,0
1,1674190252431911356,1,0,0,1,0,1,0,0.0,,01/22/2023 09:46 PM,0,0,0
1,1674190415640668880,2,1,1,1,0,1,0,0.0,0.0,01/22/2023 09:44 PM,0,1,0
1,1806753638588148344,2,0,0,1,0,1,0,,,05/01/2023 03:06 PM,0,0,0
1,1677249785174431770,0,0,0,1,0,1,1,0.0,,01/22/2023 09:46 PM,0,0,0
1,1674190175122499898,1,0,0,1,0,1,1,,,01/22/2023 09:45 PM,0,0,0
1,1806753665682850716,2,0,0,1,0,1,0,0.0,,05/01/2023 03:06 PM,0,0,0
1,1674190291086617084,2,0,0,1,0,1,0,,,01/22/2023 09:46 PM,0,0,0
1,1674190467180276534,1,0,0,1,0,1,0,,,01/22/2023 09:45 PM,0,0,0
1,1674190467180276528,0,2,2,1,0,1,0,0.0,0.0,01/22/2023 09:46 PM,0,2,0
1,1695780087377656306,1,0,0,1,0,1,0,0.0,,01/22/2023 09:47 PM,0,0,0
1,1674190239547009456,0,0,0,1,0,1,1,0.0,0.0,01/22/2023 09:46 PM,0,0,0
1,1674190514424916872,1,0,0,1,0,1,1,0.0,0.0,01/22/2023 09:45 PM,0,0,0
1,1674190686223609002,1,0,0,1,0,1,0,,,01/22/2023 09:47 PM,0,0,0
1,1674190239547009458,5,0,0,1,0,1,1,0.0,0.0,01/22/2023 09:44 PM,0,0,0
1,1674190265316813264,1,0,0,1,0,1,0,,,01/22/2023 09:46 PM,0,0,0
1,1806753639913046780,0,2,2,1,0,1,0,0.0,0.0,05/01/2023 03:06 PM,0,2,0
1,1683527972235589666,0,1,1,1,0,1,1,0.0,0.0,01/22/2023 09:46 PM,0,1,0
1,1806749744377709060,2,0,0,1,0,1,0,,,05/01/2023 02:51 PM,0,0,0
1,1674190557374589902,1,3,3,1,0,1,0,0.0,0.0,01/22/2023 09:44 PM,0,3,0
1,1674190544489687992,0,2,2,1,0,1,0,0.0,0.0,01/22/2023 09:45 PM,0,2,0
1,1674190355511126652,2,0,0,1,0,1,0,0.0,,01/22/2023 09:46 PM,0,0,0
1,1715846704448749936,1,0,0,1,0,1,0,0.0,,01/22/2023 09:47 PM,0,0,0
1,1674190454295374622,1,0,0,1,0,1,0,,,01/22/2023 09:44 PM,0,0,0
1,1674190334036290136,2,3,3,1,0,1,0,0.0,0.0,01/22/2023 09:45 PM,0,3,0
1,1806749757262611032,2,0,0,1,0,1,0,,,05/01/2023 02:51 PM,0,0,0
1,1674190578849426420,1,0,0,1,0,1,1,0.0,0.0,01/22/2023 09:47 PM,0,0,0
1,1674190213777205626,10,0,0,1,0,1,0,3.0,0.0,01/22/2023 09:45 PM,0,0,0
1,1674190381280930480,1,1,1,1,0,1,0,0.0,0.0,01/22/2023 09:45 PM,0,1,0
1,1594046400988140226,8,0,0,1,0,1,1,0.0,,01/22/2023 09:45 PM,0,0,0
1,1594046443937813244,7,1,1,1,0,1,0,0.0,0.0,01/22/2023 09:44 PM,0,1,0
1,1674190243841976756,2,0,0,1,0,1,0,0.0,,01/22/2023 09:45 PM,0,0,0
1,1806753629998213750,4,0,0,1,0,1,0,,,05/01/2023 03:06 PM,0,0,0
1,1695776956346497674,1,0,0,1,0,1,0,,,01/22/2023 09:46 PM,0,0,0
1,1827484051430132402,4,0,0,1,0,1,0,,,06/26/2023 11:51 AM,0,0,0
1,1806749748672676384,2,2,2,1,0,1,0,0.0,0.0,05/04/2023 01:12 PM,0,2,0
1,1806749752967643712,2,0,0,1,0,1,0,,,05/01/2023 02:51 PM,0,0,0
1,1674190557374589898,3,0,0,1,0,1,0,0.0,,01/22/2023 09:44 PM,0,0,0
1,1806753669977818020,2,0,0,1,0,1,0,,,05/01/2023 03:06 PM,0,0,0
1,1674190570259491812,0,2,2,1,0,1,0,0.0,0.0,01/22/2023 09:44 PM,0,2,0
1,1677249871073777806,2,0,0,1,0,1,0,0.0,,01/22/2023 09:47 PM,0,0,0
1,1674190437115505412,1,1,1,1,0,1,0,0.0,0.0,01/22/2023 09:47 PM,0,1,0
1,1674190411345701582,1,0,0,1,0,1,0,0.0,,01/22/2023 09:46 PM,0,0,0
1,1674190351216159354,9,0,0,1,0,1,0,,,01/22/2023 09:45 PM,0,0,0
1,1674190321151388220,1,2,2,1,0,1,0,0.0,0.0,01/22/2023 09:45 PM,0,2,0
1,1674190213777205624,1,0,0,1,0,1,0,0.0,,01/22/2023 09:44 PM,0,0,0
1,1695776956940644828,1,0,0,1,0,1,0,,,01/22/2023 09:45 PM,0,0,0
1,1695776985249749776,0,1,1,1,0,1,0,0.0,0.0,01/22/2023 09:46 PM,0,1,0
1,1674190338331257438,3,0,0,1,0,1,0,0.0,,01/22/2023 09:45 PM,0,0,0
1,1695776991300383220,1,0,0,1,0,1,0,,,01/22/2023 09:44 PM,0,0,0
1,1695776969825546724,1,0,0,1,0,1,0,,,01/22/2023 09:44 PM,0,0,0
1,1806749757262611020,2,0,0,1,0,1,0,,,05/04/2023 01:08 PM,0,0,0
1,1695780083082689004,2,0,0,1,0,1,0,0.0,,01/22/2023 09:45 PM,0,0,0
1,1674190480065178436,1,0,0,1,0,1,0,0.0,,01/22/2023 09:47 PM,0,0,0
1,1674190643273935964,1,0,0,1,0,1,0,,,01/22/2023 09:46 PM,0,0,0
1,1674190364101061264,2,0,0,1,0,1,0,,,01/22/2023 09:44 PM,0,0,0
1,1683527957294958598,1,0,0,1,0,1,0,0.0,,01/22/2023 09:44 PM,0,0,0
1,1806753639913046764,2,0,0,1,0,1,0,,,05/01/2023 03:06 PM,0,0,0
1,1674190303971518998,2,0,0,1,0,1,0,,,01/22/2023 09:46 PM,0,0,0
1,1674190175122499894,2,0,0,1,0,1,0,0.0,,01/22/2023 09:46 PM,0,0,0
1,1806753652797948722,2,0,0,1,0,1,0,,,05/01/2023 03:06 PM,0,0,0
1,1674190312561453608,1,0,0,1,0,1,0,,,01/22/2023 09:47 PM,0,0,0
1,1674190488655113046,0,3,3,1,0,1,0,0.0,0.0,01/22/2023 09:45 PM,0,3,0
1,1677249841009006688,1,0,0,1,0,1,0,,,01/22/2023 09:46 PM,0,0,0
1,1674190346921192050,4,2,2,1,0,1,0,0.0,0.0,01/22/2023 09:46 PM,0,2,0
1,1677249858188875902,1,1,1,1,0,1,0,0.0,0.0,01/22/2023 09:45 PM,0,1,0
1,1594046431052911340,2,7,7,1,0,1,0,1.0,0.0,01/22/2023 09:44 PM,0,7,0
1,1806749757262611010,2,0,0,1,0,1,0,,,05/01/2023 02:51 PM,0,0,0
1,1806749744377709068,11,0,0,1,0,1,0,0.0,,05/01/2023 02:51 PM,0,0,0
1,1806749727197839814,3,1,1,1,0,1,0,0.0,0.0,05/04/2023 12:51 PM,0,1,0
1,1563698718386161690,3,5,5,1,0,1,0,0.0,0.0,01/22/2023 09:45 PM,0,5,0
1,1683527972235589660,1,0,0,1,0,1,0,0.0,,01/22/2023 09:46 PM,0,0,0
1,1674190381280930476,2,0,0,1,0,1,0,,,01/22/2023 09:45 PM,0,0,0
1,1695777008480252434,2,0,0,1,0,1,0,0.0,,01/22/2023 09:45 PM,0,0,0
1,1715823826949039076,1,0,0,1,0,1,0,0.0,,01/22/2023 09:45 PM,0,0,0
1,1695777002429618974,1,0,0,1,0,1,0,,,01/22/2023 09:46 PM,0,0,0
1,1677249836714039390,1,0,0,0,0,0,0,,,06/22/2023 09:44 AM,0,0,0
1,1715823822654071768,1,1,1,1,0,1,0,0.0,0.0,01/22/2023 09:47 PM,0,1,0
1,1674190450000407318,2,0,0,1,0,1,0,,,05/11/2023 11:18 AM,0,0,0
1,1674190170827532586,0,1,1,1,0,1,0,0.0,0.0,01/22/2023 09:46 PM,0,1,0
1,1677249802354300976,1,0,0,1,0,1,0,,,01/22/2023 09:47 PM,0,0,0
1,1674190286791649782,2,0,0,1,0,1,0,,,01/22/2023 09:44 PM,0,0,0
1,1674190497245047656,2,1,1,1,0,1,0,0.0,0.0,01/22/2023 09:45 PM,0,1,0
1,1674190265316813262,1,0,0,1,0,1,0,,,01/22/2023 09:46 PM,0,0,0
1,1806749744377709058,2,0,0,1,0,1,0,,,05/01/2023 02:51 PM,0,0,0
1,1561012883010990646,0,10,10,1,0,1,1,0.0,0.0,05/04/2023 01:30 PM,0,10,0
1,1806753648502981418,2,0,0,1,0,1,0,,,05/01/2023 03:06 PM,0,0,0
1,1436495122378528446,4,1,1,1,0,1,1,2.0,0.0,01/22/2023 09:46 PM,0,1,0
1,1571105055115583500,7,1,1,1,0,1,0,0.0,0.0,01/22/2023 09:45 PM,0,1,0
1,1674190587439361022,4,0,0,1,0,1,0,1.0,0.0,01/22/2023 09:46 PM,0,0,0
1,1715823829734775372,1,0,0,1,0,1,0,1.0,0.0,01/22/2023 09:47 PM,0,0,0
1,1806749748672676390,0,2,2,1,0,1,0,0.0,0.0,05/01/2023 02:51 PM,0,2,0
1,1674190145057728766,2,1,1,1,0,1,0,0.0,0.0,01/22/2023 09:46 PM,0,1,0
1,1677249853893908600,2,0,0,1,0,1,0,0.0,,01/22/2023 09:47 PM,0,0,0
1,1521679584953491780,1,4,4,1,0,1,2,0.0,0.0,01/22/2023 09:44 PM,0,4,0
1,1715846700153782636,2,0,0,1,0,1,0,0.0,,01/22/2023 09:45 PM,0,0,0
1,1677249785174431766,1,0,0,1,0,1,0,,,01/22/2023 09:44 PM,0,0,0
1,1500206163166594382,8,1,1,1,0,1,0,0.0,0.0,05/25/2023 04:29 PM,0,1,0
1,1806749752967643708,3,0,0,1,0,1,0,,,05/01/2023 02:51 PM,0,0,0
1,1683527959350687752,1,0,0,1,0,1,0,,,01/22/2023 09:47 PM,0,0,0
1,1674190222367140232,7,1,1,1,0,1,0,0.0,0.0,01/22/2023 09:45 PM,0,1,0
1,1674190256726878654,1,0,0,1,0,1,0,,,01/22/2023 09:47 PM,0,0,0
1,1674190166532565276,2,0,0,1,0,1,0,0.0,,01/22/2023 09:45 PM,0,0,0
1,1674190531604786074,1,0,0,1,0,1,0,0.0,,01/22/2023 09:45 PM,0,0,0
1,1806753644208014088,2,0,0,1,0,1,0,,,05/01/2023 03:06 PM,0,0,0
1,1677249798059333678,1,0,0,1,0,1,0,,,01/22/2023 09:46 PM,0,0,0
1,1521686986436309688,12,0,0,1,0,1,0,2.0,2.0,05/25/2023 04:32 PM,0,0,0
1,1674190492950080346,2,0,0,1,0,1,0,0.0,,01/22/2023 09:45 PM,0,0,0
1,1674190196597336410,2,0,0,1,0,1,0,,,01/22/2023 09:47 PM,0,0,0
1,1695777004185285124,3,0,0,1,0,1,0,0.0,,01/22/2023 09:45 PM,0,0,0
1,1806753652797948752,2,0,0,1,0,1,0,,,05/01/2023 03:06 PM,0,0,0
1,1806749752967643704,2,0,0,1,0,1,0,,,05/01/2023 02:51 PM,0,0,0
1,1674190540194720688,1,0,0,1,0,1,0,,,01/22/2023 09:46 PM,0,0,0
1,1674190669043739798,1,0,0,1,0,1,0,,,01/22/2023 09:46 PM,0,0,0
1,1677249802354300980,4,0,0,1,0,1,0,,,01/22/2023 09:46 PM,0,0,0
1,1674190638978968660,1,0,0,1,0,1,0,,,01/22/2023 09:46 PM,0,0,0
1,1806753652797948746,2,0,0,1,0,1,0,,,05/01/2023 03:06 PM,0,0,0
1,1806749755937712544,2,0,0,1,0,1,0,,,05/01/2023 02:51 PM,0,0,0
1,1683527959350687758,0,2,2,1,0,1,0,0.0,0.0,01/22/2023 09:47 PM,0,2,0
1,1674190497245047650,1,0,0,1,0,1,0,,,01/22/2023 09:47 PM,0,0,0
1,1715846705501012844,2,0,0,1,0,1,0,0.0,,01/22/2023 09:45 PM,0,0,0
1,1674190544489687988,1,0,0,1,0,1,0,,,01/22/2023 09:44 PM,0,0,0
1,1806749752967643710,1,1,1,1,0,1,0,0.0,0.0,05/01/2023 02:51 PM,0,1,0
1,1674190291086617088,1,0,0,1,0,1,0,0.0,,01/22/2023 09:44 PM,0,0,0
1,1695776985071215288,0,1,1,1,0,1,0,0.0,0.0,01/22/2023 09:44 PM,0,1,0
1,1674190286791649780,3,0,0,1,0,1,0,,,01/22/2023 09:46 PM,0,0,0
1,1677249879663712420,1,1,1,1,0,1,0,0.0,0.0,01/22/2023 09:45 PM,0,1,0
1,1674190553079622598,1,0,0,1,0,1,0,,,01/22/2023 09:47 PM,0,0,0
1,1806753639913046778,2,0,0,1,0,1,0,,,05/01/2023 03:06 PM,0,0,0
1,1806753655768017532,1,0,0,1,0,1,1,,,05/01/2023 03:06 PM,0,0,0
1,1674190634684001358,0,3,3,1,0,1,0,0.0,0.0,01/22/2023 09:45 PM,0,3,0
1,1674190458590341928,1,0,0,1,0,1,0,0.0,,01/22/2023 09:44 PM,0,0,0
1,1674190256726878658,1,1,1,1,0,1,0,0.0,0.0,01/22/2023 09:45 PM,0,1,0
1,1594046392398205628,5,4,4,1,0,1,0,0.0,0.0,01/22/2023 09:45 PM,0,4,0
1,1594046405283107532,1,8,8,1,0,1,0,0.0,0.0,01/22/2023 09:45 PM,0,8,0
1,1674190694813543600,3,0,0,1,0,1,0,0.0,,01/22/2023 09:44 PM,0,0,0
1,1715823805474202572,1,0,0,1,0,1,0,,,01/22/2023 09:47 PM,0,0,0
1,1448642183732401788,6,0,0,1,0,1,2,0.0,0.0,01/22/2023 09:45 PM,0,0,0
1,1806749727197839810,2,0,0,1,0,1,0,,,05/09/2023 11:48 AM,0,0,0
1,1715823821144840768,2,0,0,1,0,1,0,0.0,,01/22/2023 09:47 PM,0,0,0
1,1674190617504132140,4,0,0,1,0,1,0,0.0,,01/22/2023 09:44 PM,0,0,0
1,1674190424230603488,1,0,0,1,0,1,0,0.0,,01/22/2023 09:47 PM,0,0,0
1,1674190329741322834,3,0,0,1,0,1,0,0.0,,01/22/2023 09:45 PM,0,0,0
1,1806749722902872498,4,0,0,1,0,1,0,,,05/09/2023 11:42 AM,0,0,0
1,1674190179417467200,1,0,0,1,0,1,1,0.0,0.0,01/22/2023 09:47 PM,0,0,0
1,1674190664748772492,1,1,1,1,0,1,0,0.0,0.0,01/22/2023 09:44 PM,0,1,0
1,1674190591734328326,0,1,1,1,0,1,0,0.0,0.0,01/22/2023 09:44 PM,0,1,0
1,1593766343243326364,8,1,1,1,0,1,0,0.0,0.0,01/22/2023 09:45 PM,0,1,0
1,1674190643273935966,1,0,0,1,0,1,0,,,01/22/2023 09:45 PM,0,0,0
1,1674190583144393720,1,0,0,1,0,1,0,0.0,,01/22/2023 09:45 PM,0,0,0
1,1674190364101061260,1,0,0,1,0,1,0,0.0,,01/22/2023 09:44 PM,0,0,0
1,1674190278201715178,1,0,0,1,0,1,0,,,01/22/2023 09:46 PM,0,0,0
1,1674190600324262932,1,0,0,1,0,1,0,0.0,,01/22/2023 09:47 PM,0,0,0
1,1674190196597336406,1,0,0,1,0,1,0,,,01/22/2023 09:46 PM,0,0,0
1,1674190372690995868,1,0,0,1,0,1,0,0.0,,01/22/2023 09:45 PM,0,0,0
1,1563698688321392630,0,8,8,1,0,1,1,0.0,0.0,01/22/2023 09:44 PM,0,8,0
1,1683527931525155816,1,0,0,1,0,1,0,,,01/22/2023 09:45 PM,0,0,0
1,1806753635618079454,2,0,0,1,0,1,0,,,05/01/2023 03:06 PM,0,0,0
1,1677249776584497168,1,1,1,1,0,1,0,0.0,0.0,01/22/2023 09:47 PM,0,1,0
1,1674190587439361024,1,0,0,1,0,1,0,0.0,,01/22/2023 09:44 PM,0,0,0
1,1806749744377709066,1,1,1,1,0,1,0,0.0,0.0,05/01/2023 02:51 PM,0,1,0
1,1674190553079622600,0,2,2,1,0,1,0,0.0,0.0,01/22/2023 09:44 PM,0,2,0
1,1674190553079622596,0,1,1,1,0,1,0,0.0,0.0,01/22/2023 09:46 PM,0,1,0
1,1695776980954782472,1,0,0,1,0,1,1,,,01/22/2023 09:45 PM,0,0,0
1,1674190462885309230,1,1,1,1,0,1,0,0.0,0.0,01/22/2023 09:47 PM,0,1,0
1,1695777019609488196,2,1,1,1,0,1,0,0.0,0.0,01/22/2023 09:45 PM,0,1,0
1,1674190656158837890,4,0,0,1,0,1,0,,,01/22/2023 09:44 PM,0,0,0
1,1674190505834982260,1,0,0,1,0,1,0,,,01/22/2023 09:44 PM,0,0,0
1,1674190295381584396,0,2,2,1,0,1,0,0.0,0.0,01/22/2023 09:46 PM,0,2,0
1,1674190325446355526,1,0,0,1,0,1,0,0.0,,01/22/2023 09:44 PM,0,0,0
1,1575949510978564828,5,3,3,1,0,1,0,0.0,0.0,01/22/2023 09:47 PM,0,3,0
1,1674190604619230232,6,0,0,1,0,1,0,0.0,,01/22/2023 09:45 PM,0,0,0
1,1673852326282066544,1,0,0,1,0,1,0,0.0,,01/22/2023 09:46 PM,0,0,0
1,1695776963774913278,1,0,0,1,0,1,0,,,01/22/2023 09:46 PM,0,0,0
1,1674190535899753386,2,0,0,1,0,1,2,0.0,0.0,01/22/2023 09:47 PM,0,0,0
1,1695780087377656308,1,0,0,1,0,1,0,0.0,,01/22/2023 09:47 PM,0,0,0
1,1674190638978968664,1,0,0,1,0,1,0,,,01/22/2023 09:47 PM,0,0,0
1,1806753648502981416,1,1,1,1,0,1,0,0.0,0.0,05/01/2023 03:06 PM,0,1,0
1,1677249883958679722,1,0,0,1,0,1,0,,,01/22/2023 09:46 PM,0,0,0
1,1677249832419072086,0,1,1,1,0,1,1,0.0,0.0,01/22/2023 09:45 PM,0,1,0
1,1674190561669557206,2,0,0,1,0,1,0,,,01/22/2023 09:45 PM,0,0,0
1,1806749757262611014,4,0,0,1,0,1,0,,,05/04/2023 01:03 PM,0,0,0
1,1674190368396028568,1,0,0,1,0,1,0,,,01/22/2023 09:45 PM,0,0,0
1,1677249849598941294,1,0,0,1,0,1,0,,,01/22/2023 09:45 PM,0,0,0
1,1827474404723843684,1,0,0,1,0,1,0,0.0,,06/26/2023 11:14 AM,0,0,0
1,1674190334036290138,3,0,0,1,0,1,0,0.0,,01/22/2023 09:47 PM,0,0,0
1,1674190407050734270,8,1,1,1,0,1,1,0.0,0.0,01/22/2023 09:44 PM,0,1,0
1,1677249780879464466,0,1,1,1,0,1,0,0.0,0.0,01/22/2023 09:45 PM,0,1,0
1,1674190540194720684,1,0,0,1,0,1,0,,,01/22/2023 09:45 PM,0,0,0
1,1674190218072172928,0,0,0,1,0,1,2,0.0,,01/22/2023 09:45 PM,0,0,0
1,1695776948350710230,0,0,0,1,0,1,2,0.0,,01/22/2023 09:44 PM,0,0,0
1,1674190510129949570,6,0,0,1,0,1,0,0.0,,01/22/2023 09:45 PM,0,0,0
1,1674190574554459112,1,0,0,1,0,1,0,,,01/22/2023 09:45 PM,0,0,0
1,1695780083082689008,9,0,0,1,0,1,0,0.0,,01/22/2023 09:46 PM,0,0,0
1,1674190136467794156,1,0,0,1,0,1,1,0.0,0.0,01/22/2023 09:47 PM,0,0,0
1,1674190162237597978,1,0,0,1,0,1,0,0.0,,01/22/2023 09:44 PM,0,0,0
1,1677249772289529870,1,0,0,1,0,1,0,1.0,0.0,01/22/2023 09:45 PM,0,0,0
1,1674190428525570794,0,0,0,1,0,1,1,,,01/22/2023 09:45 PM,0,0,0
1,1677249793764366374,5,0,0,1,0,1,0,,,01/22/2023 09:45 PM,0,0,0
1,1674190617504132138,2,0,0,1,0,1,0,0.0,,01/22/2023 09:45 PM,0,0,0
1,1677249815239202874,1,0,0,1,0,1,0,,,01/22/2023 09:47 PM,0,0,0
1,1753333909108677614,6,0,0,0,0,0,0,0.0,,04/20/2023 04:48 PM,0,0,0
1,1806749752967643696,4,0,0,1,0,1,0,0.0,,05/01/2023 02:51 PM,0,0,0
1,1674190170827532584,1,0,0,1,0,1,0,0.0,,01/22/2023 09:44 PM,0,0,0
1,1674190445705440014,1,1,1,1,0,1,0,0.0,0.0,01/22/2023 09:47 PM,0,1,0
1,1674190162237597974,1,0,0,1,0,1,0,0.0,,01/22/2023 09:46 PM,0,0,0
1,1674190630389034058,2,0,0,1,0,1,0,0.0,,01/22/2023 09:46 PM,0,0,0
1,1806749727197839808,2,0,0,1,0,1,0,,,05/09/2023 11:42 AM,0,0,0
1,1806753665682850708,2,0,0,1,0,1,0,,,05/01/2023 03:06 PM,0,0,0
1,1674190578849426418,2,0,0,1,0,1,0,0.0,,01/22/2023 09:46 PM,0,0,0
1,1677249866778810506,1,0,0,1,0,1,0,0.0,,01/22/2023 09:45 PM,0,0,0
1,1674190325446355528,0,0,0,1,0,1,1,0.0,,01/22/2023 09:44 PM,0,0,0
1,1582242289567815208,5,1,1,1,0,1,0,0.0,0.0,01/22/2023 09:46 PM,0,1,0
1,1806753631323112142,2,0,0,1,0,1,0,,,05/01/2023 03:06 PM,0,0,0
1,1594046439642845942,0,3,3,1,0,1,1,0.0,0.0,01/22/2023 09:46 PM,0,3,0
1,1674190243841976758,0,2,2,1,0,1,0,0.0,0.0,05/08/2023 09:37 AM,0,2,0
1,1674190617504132142,2,0,0,1,0,1,0,0.0,,01/22/2023 09:45 PM,0,0,0
1,1674190462885309228,1,0,0,1,0,1,1,,,01/22/2023 09:47 PM,0,0,0
1,1806749734462876060,3,1,1,1,0,1,0,0.0,0.0,05/01/2023 02:51 PM,0,1,0
1,1806753635618079458,2,0,0,1,0,1,0,0.0,,05/01/2023 03:06 PM,0,0,0
1,1677249828124104782,1,0,0,1,0,1,0,,,01/22/2023 09:45 PM,0,0,0
1,1674190218072172926,2,0,0,1,0,1,0,,,01/22/2023 09:44 PM,0,0,0
1,1674190308266486300,0,1,1,1,0,1,0,0.0,0.0,01/22/2023 09:46 PM,0,1,0
1,1715846714090947442,1,0,0,1,0,1,0,0.0,,01/22/2023 09:46 PM,0,0,0
1,1683527927230188514,1,0,0,1,0,1,0,0.0,,01/22/2023 09:44 PM,0,0,0
1,1594046418168009436,3,3,3,1,0,1,1,0.0,0.0,01/22/2023 09:44 PM,0,3,0
1,1806749748672676386,2,0,0,1,0,1,0,,,05/01/2023 02:51 PM,0,0,0
1,1806753669977818026,2,0,0,1,0,1,0,,,05/09/2023 11:49 AM,0,0,0
1,1594046426757944042,0,4,4,1,0,1,0,0.0,0.0,01/22/2023 09:45 PM,0,4,0
1,1695776995595350522,2,0,0,1,0,1,0,,,01/22/2023 09:47 PM,0,0,0
1,1594041777104953206,4,5,5,1,0,1,1,0.0,0.0,01/22/2023 09:47 PM,0,5,0
1,1677249866778810508,2,0,0,1,0,1,0,0.0,,01/22/2023 09:45 PM,0,0,0
1,1806753639913046770,2,0,0,1,0,1,0,,,05/01/2023 03:06 PM,0,0,0
1,1677249828124104786,1,0,0,1,0,1,0,,,01/22/2023 09:45 PM,0,0,0
1,1674190261021845962,1,0,0,1,0,1,0,,,01/22/2023 09:46 PM,0,0,0
1,1677249772289529866,1,0,0,1,0,1,0,0.0,,01/22/2023 09:45 PM,0,0,0
1,1674190385575897778,1,0,0,1,0,1,0,0.0,,01/22/2023 09:47 PM,0,0,0
1,1677249871073777808,1,0,0,1,0,1,0,0.0,,01/22/2023 09:45 PM,0,0,0
1,1695776969825546726,1,0,0,1,0,1,0,,,01/22/2023 09:47 PM,0,0,0
1,1674190192302369104,1,0,0,1,0,1,0,0.0,,01/22/2023 09:45 PM,0,0,0
1,1674190428525570798,8,2,2,1,0,1,0,0.0,0.0,01/22/2023 09:45 PM,0,2,0
1,1806753648502981400,4,0,0,1,0,1,0,,,05/01/2023 03:06 PM,0,0,0
1,1674190419935636188,2,0,0,1,0,1,0,0.0,,01/22/2023 09:46 PM,0,0,0
1,1677249798059333674,1,0,0,1,0,1,0,,,01/22/2023 09:44 PM,0,0,0
1,1715823801179235264,1,0,0,1,0,1,0,,,01/22/2023 09:45 PM,0,0,0
1,1674190407050734268,3,0,0,1,0,1,0,0.0,,01/22/2023 09:46 PM,0,0,0
1,1806753648502981414,2,0,0,1,0,1,0,,,05/01/2023 03:06 PM,0,0,0
1,1715823783999366064,1,0,0,1,0,1,0,,,01/22/2023 09:44 PM,0,0,0
1,1806749752967643706,4,0,0,1,0,1,0,,,05/01/2023 02:51 PM,0,0,0
1,1594046418168009438,8,0,0,1,0,1,1,0.0,0.0,01/22/2023 09:44 PM,0,0,0
1,1436495119852630436,2,4,4,1,0,1,0,0.0,0.0,05/12/2023 09:31 AM,0,4,0
1,1436495109493626544,9,0,0,1,0,1,0,0.0,,05/25/2023 04:30 PM,0,0,0
1,1674190548784655292,1,0,0,1,0,1,1,0.0,0.0,01/22/2023 09:45 PM,0,0,0
1,1582242323927553626,0,2,2,1,0,1,0,0.0,0.0,01/22/2023 09:46 PM,0,2,0
1,1677249875368745112,1,0,0,1,0,1,0,,,01/22/2023 09:44 PM,0,0,0
1,1806749718607905162,2,0,0,1,0,1,0,,,05/01/2023 02:51 PM,0,0,0
1,1715846713038684536,1,0,0,1,0,1,0,0.0,,01/22/2023 09:44 PM,0,0,0
1,1715823816849873466,1,0,0,1,0,1,0,0.0,,01/22/2023 09:44 PM,0,0,0
1,1674190523014851472,1,0,0,1,0,1,0,0.0,,01/22/2023 09:47 PM,0,0,0
1,1674190179417467202,0,3,3,1,0,1,0,0.0,0.0,01/22/2023 09:44 PM,0,3,0
1,1806749740082741756,4,0,0,1,0,1,0,,,05/01/2023 02:51 PM,0,0,0
1,1674190673338707102,1,0,0,1,0,1,0,0.0,,01/22/2023 09:46 PM,0,0,0
1,1806749748672676382,2,0,0,1,0,1,0,,,05/03/2023 03:55 PM,0,0,0
1,1806753661387883394,2,0,0,1,0,1,0,,,05/01/2023 03:06 PM,0,0,0
1,1674190295381584392,0,1,1,1,0,1,0,0.0,0.0,01/22/2023 09:46 PM,0,1,0
1,1673852313397164652,1,0,0,1,0,1,0,0.0,,01/22/2023 09:47 PM,0,0,0
1,1674190149352696064,1,0,0,1,0,1,0,,,01/22/2023 09:46 PM,0,0,0
1,1674190364101061262,1,1,1,1,0,1,0,1.0,0.0,01/22/2023 09:46 PM,0,1,0
1,1806753661387883382,2,0,0,1,0,1,0,,,05/01/2023 03:06 PM,0,0,0
1,1594046448232780548,8,1,1,1,0,1,0,0.0,0.0,01/22/2023 09:44 PM,0,1,0
1,1674190295381584388,1,1,1,1,0,1,0,0.0,0.0,01/22/2023 09:47 PM,0,1,0
1,1594046448232780546,3,6,6,1,0,1,0,0.0,0.0,01/22/2023 09:46 PM,0,6,0
1,1827484051430132400,1,0,0,1,0,1,0,,,06/26/2023 11:51 AM,0,0,0
1,1677249789469399068,0,4,4,1,0,1,0,0.0,0.0,01/22/2023 09:46 PM,0,4,0
1,1806749740082741754,2,0,0,1,0,1,0,,,05/01/2023 02:51 PM,0,0,0
1,1806749722902872494,2,0,0,1,0,1,0,,,05/01/2023 02:51 PM,0,0,0
1,1563698684026425330,8,0,0,1,0,1,1,0.0,,01/22/2023 09:46 PM,0,0,0
1,1594046413873042132,8,1,1,1,0,1,0,1.0,1.0,01/22/2023 09:44 PM,0,1,0
1,1563698718386161692,6,2,2,1,0,1,1,0.0,0.0,01/22/2023 09:44 PM,0,2,0
1,1806749740082741752,2,0,0,1,0,1,0,,,05/01/2023 02:51 PM,0,0,0
1,1806749731492807138,4,0,0,1,0,1,0,,,05/01/2023 02:51 PM,0,0,0
1,1674190359806093962,1,0,0,1,0,1,0,,,01/22/2023 09:45 PM,0,0,0
1,1674190510129949568,2,0,0,1,0,1,0,,,01/22/2023 09:46 PM,0,0,0
1,1806749735787774444,4,0,0,1,0,1,0,,,05/04/2023 12:50 PM,0,0,0
1,1674190261021845958,1,0,0,1,0,1,0,,,01/22/2023 09:46 PM,0,0,0
1,1674190230957074838,1,0,0,1,0,1,0,0.0,,01/22/2023 09:46 PM,0,0,0
1,1695776995595350524,1,0,0,1,0,1,0,,,01/22/2023 09:45 PM,0,0,0
1,1674190669043739800,1,0,0,1,0,1,0,,,01/22/2023 09:44 PM,0,0,0
1,1674190660453805192,2,0,0,1,0,1,0,,,01/22/2023 09:46 PM,0,0,0
1,1806749735787774448,2,1,1,1,0,1,1,0.0,0.0,05/01/2023 02:51 PM,0,1,0
1,1674190299676551694,1,0,0,1,0,1,0,,,01/22/2023 09:44 PM,0,0,0
1,1806753669977818022,4,0,0,1,0,1,0,,,05/01/2023 03:06 PM,0,0,0
1,1571105063705518106,5,3,3,1,0,1,0,0.0,0.0,01/22/2023 09:45 PM,0,3,0
1,1674190621799099448,5,0,0,1,0,1,0,,,01/22/2023 09:46 PM,0,0,0
1,1715823816849873464,0,1,1,1,0,1,0,0.0,0.0,01/22/2023 09:45 PM,0,1,0
1,1683527931525155814,1,0,0,1,0,1,0,,,01/22/2023 09:44 PM,0,0,0
1,1806749718607905172,2,0,0,1,0,1,0,,,05/01/2023 02:51 PM,0,0,0
1,1806749718607905182,2,0,0,1,0,1,0,,,05/01/2023 02:51 PM,0,0,0
1,1715846708743717234,1,0,0,1,0,1,0,0.0,,01/22/2023 09:47 PM,0,0,0
1,1806753669977818016,2,0,0,1,0,1,0,,,05/01/2023 03:06 PM,0,0,0
1,1715823805474202570,1,0,0,1,0,1,0,,,01/22/2023 09:44 PM,0,0,0
1,1674190256726878660,4,0,0,1,0,1,0,0.0,,01/22/2023 09:45 PM,0,0,0
1,1448642175142467180,2,2,2,1,0,1,0,0.0,0.0,01/22/2023 09:45 PM,0,2,0
1,1674190342626224744,1,0,0,1,0,1,0,,,01/22/2023 09:44 PM,0,0,0
1,1594046422462976738,7,1,1,1,0,1,1,0.0,0.0,01/22/2023 09:45 PM,0,1,0
1,1695777004185285136,0,0,0,1,0,1,1,0.0,,01/22/2023 09:44 PM,0,0,0
1,1674190647568903276,1,0,0,1,0,1,0,0.0,,01/22/2023 09:47 PM,0,0,0
1,1806749727197839824,3,0,0,1,0,1,1,0.0,0.0,05/01/2023 02:51 PM,0,0,0
1,1582242315337619018,4,2,2,1,0,1,0,0.0,0.0,01/22/2023 09:45 PM,0,2,0
1,1683527963645655060,1,0,0,1,0,1,0,0.0,,01/22/2023 09:45 PM,0,0,0
1,1674190149352696066,1,0,0,1,0,1,0,,,01/22/2023 09:46 PM,0,0,0
1,1674190613209164838,2,0,0,1,0,1,0,0.0,,01/22/2023 09:45 PM,0,0,0
1,1594046413873042136,0,8,8,1,0,1,0,1.0,0.0,01/22/2023 09:45 PM,0,8,0
1,1806753661387883390,2,0,0,1,0,1,0,0.0,,05/01/2023 03:06 PM,0,0,0
1,1674190183712434508,2,0,0,1,0,1,0,0.0,,01/22/2023 09:44 PM,0,0,0
1,1806749722902872488,4,0,0,1,0,1,1,0.0,0.0,05/01/2023 02:51 PM,0,0,0
1,1674190630389034056,2,0,0,1,0,1,0,0.0,,01/22/2023 09:45 PM,0,0,0
1,1674190458590341924,2,0,0,1,0,1,0,0.0,,01/22/2023 09:47 PM,0,0,0
1,1715846696911078242,2,0,0,1,0,1,0,0.0,,01/22/2023 09:45 PM,0,0,0
1,1674190407050734272,0,2,2,1,0,1,0,0.0,0.0,01/22/2023 09:47 PM,0,2,0
1,1806753635618079460,2,0,0,1,0,1,0,0.0,,05/01/2023 03:06 PM,0,0,0
1,1674190312561453616,2,0,0,1,0,1,0,0.0,,01/22/2023 09:45 PM,0,0,0
1,1674190407050734276,2,0,0,1,0,1,0,,,01/22/2023 09:45 PM,0,0,0
1,1674190475770211134,1,0,0,1,0,1,0,0.0,,01/22/2023 09:44 PM,0,0,0
1,1695776985249749774,1,0,0,1,0,1,0,,,01/22/2023 09:46 PM,0,0,0
1,1674190235252042148,3,1,1,1,0,1,0,0.0,0.0,01/22/2023 09:44 PM,0,1,0
1,1674190471475243834,1,0,0,1,0,1,0,0.0,,01/22/2023 09:44 PM,0,0,0
1,1806753635618079456,2,0,0,1,0,1,0,0.0,,05/01/2023 03:06 PM,0,0,0
1,1715846709795980144,0,1,1,1,0,1,0,0.0,0.0,01/22/2023 09:46 PM,0,1,0
1,1715823808259938858,1,0,0,1,0,1,0,,,01/22/2023 09:44 PM,0,0,0
1,1674190376985963174,1,0,0,1,0,1,0,,,01/22/2023 09:45 PM,0,0,0
1,1575949519568499428,9,0,0,1,0,1,0,0.0,,04/26/2023 08:06 PM,0,0,0
1,1448642162257565290,2,1,1,1,0,1,0,0.0,0.0,01/22/2023 09:46 PM,0,1,0
1,1806749731492807140,2,0,0,1,0,1,0,,,05/12/2023 09:31 AM,0,0,0
1,1806749744377709078,4,0,0,1,0,1,0,,,05/01/2023 02:51 PM,0,0,0
1,1806753631323112136,1,1,1,1,0,1,0,0.0,0.0,05/01/2023 03:06 PM,0,1,0
1,1715823792589300662,1,0,0,1,0,1,0,,,01/22/2023 09:47 PM,0,0,0
1,1695780078787721700,2,0,0,1,0,1,0,0.0,,01/22/2023 09:44 PM,0,0,0
1,1674190153647663366,3,0,0,1,0,1,0,0.0,,01/22/2023 09:46 PM,0,0,0
1,1674190192302369108,1,0,0,1,0,1,1,,,01/22/2023 09:46 PM,0,0,0
1,1593766334653391756,6,3,3,1,0,1,0,0.0,0.0,01/22/2023 09:46 PM,0,3,0
1,1571105059410550802,4,4,4,1,0,1,0,0.0,0.0,01/22/2023 09:44 PM,0,4,0
1,1436495105198659242,6,0,0,1,0,1,1,3.0,0.0,07/28/2022 03:40 PM,0,0,0
1,1806749731492807132,3,0,0,1,0,1,0,,,05/01/2023 02:51 PM,0,0,0
1,1677249819534170178,1,0,0,1,0,1,0,,,01/22/2023 09:46 PM,0,0,0
1,1674190308266486306,1,0,0,1,0,1,1,0.0,0.0,01/22/2023 09:45 PM,0,0,0
1,1827474404723843682,4,1,1,1,0,1,0,0.0,0.0,06/26/2023 11:14 AM,0,1,0
1,1806753665682850718,2,0,0,1,0,1,0,,,05/01/2023 03:06 PM,0,0,0
1,1674190492950080348,0,2,2,1,0,1,0,0.0,0.0,01/22/2023 09:46 PM,0,2,0
1,1806753639913046774,2,0,0,1,0,1,0,,,05/01/2023 03:06 PM,0,0,0
1,1677249875368745110,1,0,0,1,0,1,0,,,01/22/2023 09:47 PM,0,0,0
1,1806749722902872482,3,0,0,1,0,1,1,0.0,0.0,05/01/2023 02:51 PM,0,0,0
1,1674190222367140236,2,0,0,1,0,1,0,0.0,,01/22/2023 09:46 PM,0,0,0
1,1806753648502981398,2,0,0,1,0,1,0,,,05/01/2023 03:06 PM,0,0,0
1,1674190677633674408,1,0,0,1,0,1,0,,,01/22/2023 09:44 PM,0,0,0
1,1715846688321143644,1,0,0,1,0,1,0,0.0,,01/22/2023 09:44 PM,0,0,0
1,1674190535899753380,1,0,0,1,0,1,0,0.0,,01/22/2023 09:45 PM,0,0,0
1,1715846700153782638,1,1,1,1,0,1,0,0.0,0.0,01/22/2023 09:46 PM,0,1,0
1,1674190183712434506,2,0,0,1,0,1,0,0.0,,01/22/2023 09:46 PM,0,0,0
1,1674190157942630672,0,0,0,1,0,1,1,,,01/22/2023 09:46 PM,0,0,0
1,1436495115557663136,8,0,0,1,0,1,0,0.0,,01/22/2023 09:44 PM,0,0,0
1,1806753665682850702,2,0,0,1,0,1,0,,,05/01/2023 03:06 PM,0,0,0
1,1674190291086617090,2,0,0,1,0,1,0,0.0,,01/22/2023 09:46 PM,0,0,0
1,1683527963645655062,1,0,0,1,0,1,0,,,01/22/2023 09:45 PM,0,0,0
1,1677249871073777812,1,0,0,1,0,1,0,,,01/22/2023 09:47 PM,0,0,0
1,1677249823829137478,2,0,0,1,0,1,0,,,01/22/2023 09:46 PM,0,0,0
1,1715823818359104470,1,0,0,1,0,1,0,0.0,,01/22/2023 09:45 PM,0,0,0
1,1695776937826575008,1,0,0,1,0,1,0,0.0,,01/22/2023 09:47 PM,0,0,0
1,1674190316856420914,4,0,0,1,0,1,0,0.0,,01/22/2023 09:47 PM,0,0,0
1,1674190458590341922,1,0,0,1,0,1,0,,,01/22/2023 09:44 PM,0,0,0
1,1674190596029295624,1,0,0,1,0,1,0,0.0,,01/22/2023 09:45 PM,0,0,0
1,1806749727197839820,2,0,0,1,0,1,0,,,05/04/2023 12:52 PM,0,0,0
1,1806753652797948724,0,2,2,1,0,1,0,0.0,0.0,05/01/2023 03:06 PM,0,2,0
1,1806753657092916070,1,1,1,1,0,1,0,0.0,0.0,05/01/2023 03:06 PM,0,1,0
1,1715823801179235270,2,0,0,1,0,1,0,,,01/22/2023 09:44 PM,0,0,0
1,1448642183732401786,4,5,5,1,0,1,0,0.0,0.0,05/19/2023 02:01 PM,0,5,0
1,1674190402755766970,1,0,0,1,0,1,0,0.0,,01/22/2023 09:45 PM,0,0,0
1,1674190235252042142,1,1,1,1,0,1,0,0.0,0.0,01/22/2023 09:47 PM,0,1,0
1,1594046392398205624,7,2,2,1,0,1,0,0.0,0.0,01/22/2023 09:44 PM,0,2,0
1,1806753635618079448,2,0,0,1,0,1,0,,,05/01/2023 03:06 PM,0,0,0
1,1594046452527747848,0,11,11,1,0,1,0,0.0,0.0,01/22/2023 09:47 PM,0,11,0
1,1806753661387883376,2,0,0,1,0,1,0,,,05/04/2023 12:48 PM,0,0,0
1,1674190514424916874,1,0,0,1,0,1,0,,,01/22/2023 09:46 PM,0,0,0
1,1806749731492807136,0,2,2,1,0,1,0,0.0,0.0,05/01/2023 02:51 PM,0,2,0
1,1561012870126088746,6,3,3,1,0,1,0,0.0,0.0,01/22/2023 09:46 PM,0,3,0
1,1674190505834982262,0,3,3,1,0,1,0,0.0,0.0,01/22/2023 09:46 PM,0,3,0
1,1563698701206292480,2,6,6,1,0,1,0,0.0,0.0,01/22/2023 09:44 PM,0,6,0
1,1674190230957074842,2,0,0,1,0,1,0,,,01/22/2023 09:44 PM,0,0,0
1,1674190514424916870,2,0,0,1,0,1,0,,,01/22/2023 09:47 PM,0,0,0
1,1806749748672676388,3,0,0,1,0,1,1,,,05/01/2023 02:51 PM,0,0,0
1,1674190188007401806,3,1,1,1,0,1,0,1.0,0.0,01/22/2023 09:46 PM,0,1,0
1,1715846691563848024,2,0,0,1,0,1,0,0.0,,01/22/2023 09:45 PM,0,0,0
1,1683527935820123118,1,0,0,1,0,1,0,0.0,,01/22/2023 09:47 PM,0,0,0
1,1674190402755766968,0,0,0,1,0,1,1,0.0,,01/22/2023 09:45 PM,0,0,0
1,1674190441410472712,5,0,0,1,0,1,0,,,01/22/2023 09:45 PM,0,0,0
1,1674190325446355532,2,0,0,1,0,1,0,0.0,,01/22/2023 09:45 PM,0,0,0
1,1674190265316813260,1,0,0,1,0,1,0,,,01/22/2023 09:45 PM,0,0,0
1,1806753661387883384,2,0,0,1,0,1,0,,,05/01/2023 03:06 PM,0,0,0
1,1674190346921192044,1,4,4,1,0,1,3,0.0,0.0,01/22/2023 09:46 PM,0,4,0
1,1715823812554906166,1,0,0,1,0,1,0,,,01/22/2023 09:44 PM,0,0,0
1,1806749744377709070,4,0,0,1,0,1,0,0.0,,05/01/2023 02:51 PM,0,0,0
1,1683527944410057716,0,3,3,1,0,1,0,0.0,0.0,01/22/2023 09:44 PM,0,3,0
1,1677249810944235574,0,6,6,1,0,1,0,0.0,0.0,01/22/2023 09:44 PM,0,6,0
1,1575949506683597522,7,2,2,1,0,1,0,0.0,0.0,01/22/2023 09:46 PM,0,2,0
1,1806753644208014100,2,0,0,1,0,1,0,,,05/01/2023 03:06 PM,0,0,0
1,1715823782490135060,1,0,0,1,0,1,0,,,01/22/2023 09:47 PM,0,0,0
1,1677249862483843202,2,0,0,1,0,1,0,0.0,,01/22/2023 09:47 PM,0,0,0
1,1683527967940622360,0,1,1,1,0,1,0,0.0,0.0,01/22/2023 09:46 PM,0,1,0
1,1674190454295374616,1,1,1,1,0,1,0,0.0,0.0,01/22/2023 09:47 PM,0,1,0
1,1695777014128478334,2,0,0,1,0,1,0,0.0,,01/22/2023 09:45 PM,0,0,0
1,1674190651863870576,2,2,2,1,0,1,1,0.0,0.0,01/22/2023 09:47 PM,0,2,0
1,1674190677633674406,2,0,0,1,0,1,0,0.0,,01/22/2023 09:44 PM,0,0,0
1,1674190484360145738,0,3,3,1,0,1,1,0.0,0.0,01/22/2023 09:47 PM,0,3,0
1,1677249888253647030,1,0,0,1,0,1,0,,,01/22/2023 09:44 PM,0,0,0
1,1677249853893908598,1,0,0,1,0,1,0,,,01/22/2023 09:44 PM,0,0,0
1,1448642188027369090,0,4,4,1,0,1,1,0.0,0.0,01/22/2023 09:44 PM,0,4,0
1,1695776946416509604,1,0,0,1,0,1,0,0.0,,01/22/2023 09:45 PM,0,0,0
1,1674190183712434504,2,0,0,1,0,1,0,0.0,,01/22/2023 09:47 PM,0,0,0
1,1674190656158837882,1,0,0,1,0,1,0,0.0,,01/22/2023 09:45 PM,0,0,0
1,1575949528657471478,5,3,3,1,0,1,0,0.0,0.0,01/22/2023 09:45 PM,0,3,0
1,1806753647178082938,2,0,0,1,0,1,0,,,05/01/2023 03:06 PM,0,0,0
1,1715846718385914740,1,1,1,1,0,1,0,0.0,0.0,01/22/2023 09:46 PM,0,1,0
1,1806753661387883388,2,0,0,1,0,1,0,,,05/09/2023 11:49 AM,0,0,0
1,1674190282496682480,2,0,0,1,0,1,1,,,01/22/2023 09:44 PM,0,0,0
1,1674190647568903272,3,0,0,1,0,1,0,,,01/22/2023 09:45 PM,0,0,0
1,1695776991300383222,3,0,0,1,0,1,0,,,01/22/2023 09:45 PM,0,0,0
1,1673852330577033842,1,1,1,1,0,1,0,0.0,0.0,01/22/2023 09:45 PM,0,1,0
1,1827474409018810994,2,0,0,1,0,1,1,0.0,0.0,06/26/2023 11:14 AM,0,0,0
1,1683527965884893196,1,0,0,1,0,1,0,0.0,,01/22/2023 09:47 PM,0,0,0
1,1806749727197839806,2,0,0,1,0,1,0,,,05/15/2023 04:44 PM,0,0,0
1,1827474409018810988,0,1,1,1,0,1,0,0.0,0.0,06/26/2023 11:14 AM,0,1,0
1,1674190596029295628,1,1,1,1,0,1,0,0.0,0.0,01/22/2023 09:44 PM,0,1,0
1,1674190316856420916,1,0,0,1,0,1,0,0.0,,01/22/2023 09:44 PM,0,0,0
1,1674190303971519002,1,0,0,1,0,1,0,,,01/22/2023 09:44 PM,0,0,0
1,1674190608914197534,1,0,0,1,0,1,0,,,01/22/2023 09:46 PM,0,0,0
1,1674190437115505406,0,2,2,1,0,1,0,0.0,0.0,01/22/2023 09:44 PM,0,2,0
1,1674190226662107534,0,1,1,1,0,1,0,0.0,0.0,01/22/2023 09:44 PM,0,1,0
1,1677249866778810502,1,0,0,1,0,1,0,0.0,,01/22/2023 09:44 PM,0,0,0
1,1695776976641823202,0,1,1,1,0,1,0,0.0,0.0,01/22/2023 09:45 PM,0,1,0
1,1695780078787721704,1,0,0,1,0,1,0,0.0,,01/22/2023 09:47 PM,0,0,0
1,1695776961235612130,1,0,0,1,0,1,0,,,01/22/2023 09:44 PM,0,0,0
1,1806753665682850694,1,1,1,1,2,1,0,0.0,0.0,05/12/2023 09:45 AM,0,1,0
1,1806749752967643698,4,0,0,1,0,1,0,,,05/15/2023 02:29 PM,0,0,0
1,1674190200892303714,1,0,0,1,0,1,0,,,01/22/2023 09:44 PM,0,0,0
1,1674190475770211132,1,0,0,1,0,1,0,,,01/22/2023 09:46 PM,0,0,0
1,1674190505834982258,2,0,0,1,0,1,0,1.0,0.0,01/22/2023 09:45 PM,0,0,0
1,1674190218072172924,1,0,0,1,0,1,0,,,01/22/2023 09:44 PM,0,0,0
1,1715823796884267966,1,0,0,1,0,1,0,,,01/22/2023 09:46 PM,0,0,0
1,1561012878716023344,6,2,2,1,0,1,0,0.0,0.0,01/22/2023 09:44 PM,0,2,0
1,1674190527309818772,2,0,0,1,0,1,0,0.0,,01/22/2023 09:45 PM,0,0,0
1,1674190574554459116,0,0,0,1,0,1,1,0.0,,01/22/2023 09:44 PM,0,0,0
1,1674190424230603496,1,0,0,1,0,1,0,,,01/22/2023 09:45 PM,0,0,0
1,1715846688321143646,2,0,0,1,0,1,0,0.0,,01/22/2023 09:47 PM,0,0,0
1,1594046379513303720,4,2,2,1,0,1,0,1.0,0.0,01/22/2023 09:46 PM,0,2,0
1,1806753657092916056,2,0,0,1,0,1,0,,,05/01/2023 03:06 PM,0,0,0
1,1674190226662107538,0,1,1,1,0,1,0,0.0,0.0,01/22/2023 09:45 PM,0,1,0
1,1806753661387883392,1,1,1,1,0,1,0,0.0,0.0,05/01/2023 03:06 PM,0,1,0
1,1674190308266486308,1,0,0,1,0,1,0,0.0,,01/22/2023 09:46 PM,0,0,0
1,1806753644208014096,2,0,0,1,0,1,0,,,05/01/2023 03:06 PM,0,0,0
1,1674190501540014960,2,0,0,1,0,1,0,0.0,,01/22/2023 09:46 PM,0,0,0
1,1715846695858815334,1,0,0,1,0,1,0,0.0,,01/22/2023 09:45 PM,0,0,0
1,1674190329741322832,3,0,0,1,0,1,0,0.0,,01/22/2023 09:44 PM,0,0,0
1,1806749722902872502,4,1,1,1,0,1,0,0.0,0.0,05/09/2023 11:44 AM,0,1,0
1,1575949510978564830,8,0,0,1,0,1,1,0.0,0.0,01/22/2023 09:45 PM,0,0,0
1,1683527952999991298,9,0,0,1,0,1,1,0.0,0.0,01/22/2023 09:46 PM,0,0,0
1,1674190613209164834,2,0,0,1,0,1,0,0.0,,01/22/2023 09:44 PM,0,0,0
1,1695776953225711660,1,0,0,1,0,1,0,,,01/22/2023 09:44 PM,0,0,0
1,1571105055115583502,2,6,6,1,0,1,1,0.0,0.0,01/22/2023 09:44 PM,0,6,0
1,1677249815239202878,1,0,0,1,0,1,0,,,01/22/2023 09:45 PM,0,0,0
1,1674190630389034054,1,0,0,1,0,1,0,,,01/22/2023 09:45 PM,0,0,0
1,1695780091296484234,1,0,0,1,0,1,0,0.0,,01/22/2023 09:46 PM,0,0,0
1,1677249888253647024,1,0,0,1,0,1,0,,,01/22/2023 09:45 PM,0,0,0
1,1674190523014851470,1,0,0,1,0,1,0,0.0,,01/22/2023 09:45 PM,0,0,0
1,1674190510129949562,2,0,0,1,0,1,0,,,01/22/2023 09:47 PM,0,0,0
1,1674190316856420920,0,1,1,1,0,1,0,0.0,0.0,01/22/2023 09:47 PM,0,1,0
1,1674190166532565286,4,0,0,1,0,1,1,0.0,0.0,01/22/2023 09:45 PM,0,0,0
1,1594046388103238326,5,4,4,1,0,1,0,0.0,0.0,01/22/2023 09:46 PM,0,4,0
1,1674190510129949566,1,0,0,1,0,1,0,,,01/22/2023 09:44 PM,0,0,0
1,1448642175142467184,2,2,2,1,0,1,0,0.0,0.0,05/25/2023 04:45 PM,0,2,0
1,1683527948705024000,1,0,0,1,0,1,0,0.0,,01/22/2023 09:44 PM,0,0,0
1,1677249845303973992,1,0,0,1,0,1,0,,,01/22/2023 09:47 PM,0,0,0
1,1674190351216159352,1,0,0,1,0,1,0,0.0,,01/22/2023 09:44 PM,0,0,0
1,1715823795375036962,1,0,0,1,0,1,0,,,01/22/2023 09:46 PM,0,0,0
1,1806749757262611018,2,0,0,1,0,1,0,,,05/01/2023 02:51 PM,0,0,0
1,1674190321151388226,2,0,0,1,0,1,0,,,01/22/2023 09:44 PM,0,0,0
1,1674190205187271018,1,1,1,1,0,1,0,0.0,0.0,01/22/2023 09:45 PM,0,1,0
1,1683527948705025022,1,0,0,1,0,1,0,0.0,,01/22/2023 09:45 PM,0,0,0
1,1806753644208014084,2,0,0,1,0,1,0,,,05/01/2023 03:06 PM,0,0,0
1,1594046370923369114,3,6,6,1,0,1,0,0.0,0.0,04/26/2023 08:04 PM,0,6,0
1,1695776941114034252,1,0,0,1,0,1,0,0.0,,01/22/2023 09:47 PM,0,0,0
1,1806749722902872484,8,0,0,1,0,1,0,,,05/11/2023 11:08 AM,0,0,0
1,1674190664748772494,1,0,0,1,0,1,0,,,01/22/2023 09:46 PM,0,0,0
1,1677249841009006694,1,0,0,1,0,1,0,,,01/22/2023 09:46 PM,0,0,0
1,1806753665682850704,2,0,0,1,0,1,0,,,05/01/2023 03:06 PM,0,0,0
1,1674190673338707100,0,0,0,1,0,1,1,0.0,0.0,01/22/2023 09:44 PM,0,0,0
1,1806749744377709072,2,0,0,1,0,1,0,0.0,,05/01/2023 02:51 PM,0,0,0
1,1806749727197839818,4,0,0,1,0,1,0,,,05/01/2023 02:51 PM,0,0,0
1,1674190312561453612,1,0,0,1,0,1,0,0.0,,01/22/2023 09:46 PM,0,0,0
1,1806753648502981412,2,0,0,1,0,1,0,,,05/01/2023 03:06 PM,0,0,0
1,1606778059648526978,5,4,4,1,0,1,0,0.0,1.0,01/22/2023 09:46 PM,0,4,0
1,1806749757262611028,4,0,0,1,0,1,0,,,05/01/2023 02:51 PM,0,0,0
1,1674190617504132144,1,0,0,1,0,1,0,,,01/22/2023 09:44 PM,0,0,0
1,1806753648502981410,2,0,0,1,0,1,0,0.0,,05/01/2023 03:06 PM,0,0,0
1,1674190608914197536,1,0,0,1,0,1,0,,,01/22/2023 09:44 PM,0,0,0
1,1674190273906747874,1,0,0,1,0,1,0,,,01/22/2023 09:46 PM,0,0,0
1,1674190329741322836,0,0,0,1,0,1,1,0.0,0.0,01/22/2023 09:44 PM,0,0,0
1,1674190209482238318,2,0,0,1,0,1,0,,,01/22/2023 09:46 PM,0,0,0
1,1806749740082741758,8,1,1,1,0,1,0,0.0,0.0,05/01/2023 02:51 PM,0,1,0
1,1677249819534170176,1,0,0,1,0,1,0,,,01/22/2023 09:45 PM,0,0,0
1,1715823812554906162,1,0,0,1,0,1,0,,,01/22/2023 09:45 PM,0,0,0
1,1674190467180276530,1,0,0,1,0,1,0,,,01/22/2023 09:46 PM,0,0,0
1,1674190376985963176,1,0,0,1,0,1,0,,,01/22/2023 09:46 PM,0,0,0
1,1806753635618079452,1,1,1,1,0,1,0,0.0,0.0,05/12/2023 09:33 AM,0,1,0
1,1674190415640668886,2,0,0,1,0,1,0,0.0,,01/22/2023 09:44 PM,0,0,0
1,1674190544489687990,3,0,0,1,0,1,0,,,01/22/2023 09:46 PM,0,0,0
1,1674190673338707098,1,1,1,1,0,1,0,0.0,0.0,01/22/2023 09:44 PM,0,1,0
1,1806753652797948734,2,0,0,1,0,1,0,,,05/01/2023 03:06 PM,0,0,0
1,1674190273906747868,1,0,0,1,0,1,0,,,01/22/2023 09:45 PM,0,0,0
1,1674190209482238320,2,0,0,1,0,1,0,1.0,0.0,01/22/2023 09:44 PM,0,0,0
1,1594046456830870690,3,5,5,1,0,1,0,0.0,0.0,01/22/2023 09:46 PM,0,5,0
1,1827474409018810998,3,0,0,1,0,1,0,,,06/26/2023 11:14 AM,0,0,0
1,1674190531604786080,1,0,0,1,0,1,0,0.0,,01/22/2023 09:46 PM,0,0,0
1,1674190608914197532,2,0,0,1,0,1,0,0.0,,01/22/2023 09:46 PM,0,0,0
1,1674190200892303716,1,0,0,1,0,1,0,,,01/22/2023 09:45 PM,0,0,0
1,1674190527309818770,0,1,1,1,0,1,2,0.0,0.0,01/22/2023 09:45 PM,0,1,0
1,1674190424230603494,1,0,0,1,0,1,0,,,01/22/2023 09:46 PM,0,0,0
1,1677249793764366368,1,0,0,1,0,1,0,0.0,,01/22/2023 09:47 PM,0,0,0
1,1674190338331257440,1,0,0,1,0,1,0,,,01/22/2023 09:46 PM,0,0,0
1,1806753652797948750,2,0,0,1,0,1,0,,,05/03/2023 03:54 PM,0,0,0
1,1674190656158837886,2,0,0,1,0,1,0,,,01/22/2023 09:46 PM,0,0,0
1,1806753657092916064,2,0,0,1,0,1,0,,,05/09/2023 04:47 PM,0,0,0
1,1448642179437434482,0,9,9,1,0,1,0,0.0,0.0,01/22/2023 09:47 PM,0,9,0
1,1806749731492807134,2,0,0,1,0,1,0,,,05/01/2023 02:51 PM,0,0,0
1,1806753631323112134,2,0,0,1,0,1,0,,,05/01/2023 03:06 PM,0,0,0
1,1806749744377709074,2,0,0,1,0,1,0,,,05/01/2023 02:51 PM,0,0,0
1,1806749718607905154,2,0,0,1,0,1,0,,,05/01/2023 02:51 PM,0,0,0
1,1674190561669557208,2,0,0,1,0,1,0,1.0,0.0,01/22/2023 09:44 PM,0,0,0
1,1674190286791649784,0,5,5,1,0,1,0,0.0,0.0,01/22/2023 09:45 PM,0,5,0
1,1674190535899753382,1,0,0,1,0,1,0,,,01/22/2023 09:47 PM,0,0,0
1,1695776944055742932,2,0,0,1,0,1,0,0.0,,05/08/2023 09:39 AM,0,0,0
1,1806749718607905168,2,0,0,1,0,1,0,,,05/01/2023 02:51 PM,0,0,0
1,1806753644208014098,0,2,2,1,0,1,2,0.0,0.0,05/01/2023 03:06 PM,0,2,0
1,1674190454295374620,1,0,0,1,0,1,0,,,01/22/2023 09:46 PM,0,0,0
1,1674190557374589904,2,0,0,1,0,1,0,0.0,,01/22/2023 09:44 PM,0,0,0
1,1677249853893908602,10,0,0,1,0,1,0,0.0,,01/22/2023 09:44 PM,0,0,0
1,1674190634684001360,1,1,1,1,0,1,0,0.0,0.0,01/22/2023 09:45 PM,0,1,0
1,1806753652797948732,2,0,0,1,0,1,0,,,05/09/2023 11:47 AM,0,0,0
1,1806749735787774446,2,0,0,1,0,1,0,,,05/01/2023 02:51 PM,0,0,0
1,1674190673338707104,1,0,0,1,0,1,0,0.0,,01/22/2023 09:47 PM,0,0,0
1,1674190694813543598,1,1,1,1,0,1,0,0.0,0.0,01/22/2023 09:44 PM,0,1,0
1,1806753644208014090,2,0,0,1,0,1,0,,,05/01/2023 03:06 PM,0,0,0
1,1806753665682850696,2,0,0,1,0,1,0,,,05/01/2023 03:06 PM,0,0,0
1,1806749722902872486,2,0,0,1,0,1,0,,,05/01/2023 02:51 PM,0,0,0
1,1575949532952438778,8,0,0,1,0,1,1,0.0,,01/22/2023 09:47 PM,0,0,0
1,1695777003591137960,2,0,0,1,0,1,0,0.0,,01/22/2023 09:45 PM,0,0,0
1,1594046435347878642,8,1,1,1,0,1,0,0.0,0.0,01/22/2023 09:45 PM,0,1,0
1,1674190643273935970,1,0,0,1,0,1,0,,,01/22/2023 09:46 PM,0,0,0
1,1806753665682850712,2,0,0,1,0,1,0,,,05/01/2023 03:06 PM,0,0,0
1,1695777002429618978,1,0,0,1,0,1,0,,,01/22/2023 09:45 PM,0,0,0
1,1806749757262611038,4,0,0,1,0,1,0,,,05/01/2023 02:51 PM,0,0,0
1,1677249823829137480,2,0,0,1,0,1,0,,,01/22/2023 09:45 PM,0,0,0
1,1674190501540014954,0,1,1,1,0,1,0,0.0,0.0,01/22/2023 09:45 PM,0,1,0
1,1674190531604786076,2,0,0,1,0,1,0,0.0,,01/22/2023 09:46 PM,0,0,0
1,1674190548784655294,3,0,0,1,0,1,0,0.0,,01/22/2023 09:47 PM,0,0,0
1,1806749727197839828,4,0,0,1,0,1,0,,,05/01/2023 02:51 PM,0,0,0
1,1806753661387883380,0,3,3,1,0,1,0,0.0,0.0,05/01/2023 03:06 PM,0,3,0
1,1674190475770211138,1,0,0,1,0,1,0,0.0,,01/22/2023 09:47 PM,0,0,0
1,1674190166532565282,2,0,0,1,0,1,0,,,01/22/2023 09:46 PM,0,0,0
1,1677249883958679720,1,0,0,1,0,1,0,,,01/22/2023 09:44 PM,0,0,0
1,1594046409578074834,9,0,0,1,0,1,0,0.0,,01/22/2023 09:44 PM,0,0,0
1,1674190432820538104,0,1,1,1,0,1,0,0.0,0.0,05/11/2023 11:05 AM,0,1,0
1,1715846692616110944,1,0,0,1,0,1,0,2.0,0.0,01/22/2023 09:47 PM,0,0,0
1,1806749744377709062,2,0,0,1,0,1,0,,,05/01/2023 02:51 PM,0,0,0
1,1674190355511126654,1,0,0,1,0,1,0,0.0,,01/22/2023 09:44 PM,0,0,0
1,1677249836714039386,1,0,0,1,0,1,0,,,01/22/2023 09:45 PM,0,0,0
1,1674190690518576300,1,0,0,1,0,1,0,,,01/22/2023 09:46 PM,0,0,0
1,1594046422462976736,1,7,7,1,0,1,0,0.0,0.0,01/22/2023 09:44 PM,0,7,0
1,1674190230957074840,3,0,0,1,0,1,0,0.0,,01/22/2023 09:44 PM,0,0,0
1,1806753635618079450,2,0,0,1,0,1,0,,,05/01/2023 03:06 PM,0,0,0
1,1674190239547009450,1,0,0,1,0,1,0,,,01/22/2023 09:45 PM,0,0,0
1,1806753661387883374,2,0,0,1,0,1,0,,,05/01/2023 03:06 PM,0,0,0
1,1695776989544717076,1,0,0,1,0,1,0,,,01/22/2023 09:44 PM,0,0,0
1,1674190480065178438,3,0,0,1,0,1,0,0.0,,01/22/2023 09:44 PM,0,0,0
1,1448642188027369086,2,3,3,1,0,1,0,0.0,0.0,01/22/2023 09:45 PM,0,3,0
1,1806749718607905180,2,0,0,1,0,1,0,,,05/01/2023 02:51 PM,0,0,0
1,1806749722902872500,9,0,0,1,0,1,0,,,05/11/2023 11:13 AM,0,0,0
1,1674190248136944056,0,1,1,1,0,1,0,0.0,0.0,01/22/2023 09:47 PM,0,1,0
1,1683527948705025018,1,0,0,1,0,1,0,0.0,,01/22/2023 09:44 PM,0,0,0
1,1674190600324262930,1,0,0,1,0,1,0,,,01/22/2023 09:44 PM,0,0,0
1,1674190621799099444,1,0,0,1,0,1,0,0.0,,01/22/2023 09:44 PM,0,0,0
1,1674190677633674404,2,0,0,1,0,1,0,0.0,,01/22/2023 09:45 PM,0,0,0
1,1674190651863870582,0,1,1,1,0,1,0,0.0,0.0,01/22/2023 09:45 PM,0,1,0
1,1715823825439808068,0,1,1,1,0,1,0,0.0,0.0,01/22/2023 09:45 PM,0,1,0
1,1594046383808271024,8,1,1,1,0,1,0,0.0,0.0,01/22/2023 09:45 PM,0,1,0
1,1674190445705440012,0,0,0,1,0,1,1,0.0,,01/22/2023 09:45 PM,0,0,0
1,1674190544489687994,1,1,1,1,0,1,0,0.0,0.0,01/22/2023 09:46 PM,0,1,0
1,1806749722902872504,2,0,0,1,0,1,0,,,05/01/2023 02:51 PM,0,0,0
1,1806753639913046766,2,0,0,1,0,1,0,,,05/09/2023 11:45 AM,0,0,0
1,1674190591734328322,0,1,1,1,0,1,0,0.0,0.0,01/22/2023 09:44 PM,0,1,0
1,1695776957520678960,1,0,0,1,0,1,0,,,01/22/2023 09:45 PM,0,0,0
1,1594046461117682452,1,4,4,1,0,1,1,1.0,0.0,05/13/2024 03:11 PM,0,4,0
1,1806753648502981420,2,0,0,1,0,1,0,,,05/01/2023 03:06 PM,0,0,0
1,1674190441410472710,2,0,0,1,0,1,0,0.0,,05/08/2023 09:39 AM,0,0,0
1,1674190269611780570,1,0,0,1,0,1,0,,,01/22/2023 09:46 PM,0,0,0
1,1695776942300076784,1,0,0,1,0,1,0,0.0,,01/22/2023 09:46 PM,0,0,0
1,1674190205187271016,2,0,0,1,0,1,0,,,01/22/2023 09:44 PM,0,0,0
1,1436495109493626546,0,4,4,1,0,1,2,3.0,0.0,07/28/2022 03:42 PM,0,4,0
1,1674190166532565278,1,0,0,1,0,1,0,,,01/22/2023 09:45 PM,0,0,0
1,1436495105198659246,4,1,1,1,0,1,1,1.0,0.0,07/28/2022 03:42 PM,0,1,0
1,1674190565964524510,2,0,0,1,0,1,0,,,01/22/2023 09:46 PM,0,0,0
1,1806753661387883378,0,2,2,1,0,1,1,0.0,0.0,05/01/2023 03:06 PM,0,2,0
1,1806753657092916074,2,0,0,1,0,1,0,,,05/01/2023 03:06 PM,0,0,0
1,1594046362333434512,8,0,0,1,0,1,1,0.0,,05/16/2023 09:36 AM,0,0,0
1,1594046439642845944,2,2,2,1,0,1,2,0.0,0.0,01/22/2023 09:47 PM,0,2,0
1,1674190213777205620,2,0,0,1,0,1,0,0.0,,01/22/2023 09:44 PM,0,0,0
1,1806749757262611022,2,0,0,1,0,1,0,,,05/01/2023 02:51 PM,0,0,0
1,1827484051430132398,2,0,0,1,0,1,0,,,06/26/2023 11:51 AM,0,0,0
1,1674190492950080350,1,0,0,1,0,1,0,,,01/22/2023 09:45 PM,0,0,0
1,1674190570259491814,2,0,0,1,0,1,0,0.0,,01/22/2023 09:44 PM,0,0,0
1,1677249862483843204,2,0,0,1,0,1,0,0.0,,01/22/2023 09:44 PM,0,0,0
1,1806753631323112124,1,0,0,1,0,1,1,,,05/01/2023 03:06 PM,0,0,0
1,1674190638978968662,2,0,0,1,0,1,0,,,01/22/2023 09:44 PM,0,0,0
1,1806749731492807146,1,1,1,1,0,1,0,0.0,0.0,05/04/2023 12:48 PM,0,1,0
1,1806749748672676380,4,0,0,1,0,1,0,,,05/01/2023 02:51 PM,0,0,0
1,1683527942170819574,1,0,0,1,0,1,0,0.0,,01/22/2023 09:44 PM,0,0,0
1,1683527950760754170,2,0,0,1,0,1,0,0.0,,01/22/2023 09:44 PM,0,0,0
1,1695776940340809768,1,0,0,1,0,1,0,0.0,,01/22/2023 09:46 PM,0,0,0
1,1674190583144393718,0,3,3,1,0,1,1,0.0,0.0,01/22/2023 09:46 PM,0,3,0
1,1806753652797948726,2,0,0,1,0,1,0,,,05/01/2023 03:06 PM,0,0,0
1,1827474404723843690,2,0,0,1,0,1,0,,,06/26/2023 11:14 AM,0,0,0
1,1806749748672676394,4,0,0,1,0,1,0,,,05/01/2023 02:51 PM,0,0,0
1,1806749757262611030,3,0,0,1,0,1,0,,,05/01/2023 02:51 PM,0,0,0
1,1674190157942630668,1,0,0,1,0,1,0,,,01/22/2023 09:45 PM,0,0,0
1,1674190450000407312,1,0,0,1,0,1,0,,,01/22/2023 09:46 PM,0,0,0
1,1715823779704398766,2,0,0,1,0,1,0,,,01/22/2023 09:45 PM,0,0,0
1,1674190372690995870,1,0,0,1,0,1,0,0.0,,01/22/2023 09:46 PM,0,0,0
1,1806753648502981404,2,0,0,1,0,1,0,,,05/01/2023 03:06 PM,0,0,0
1,1806753648502981424,2,0,0,1,0,1,0,,,05/01/2023 03:06 PM,0,0,0
1,1806749727197839816,4,2,2,1,0,1,0,0.0,0.0,05/04/2023 12:51 PM,0,2,0
1,1674190192302369106,1,0,0,1,0,1,0,,,01/22/2023 09:46 PM,0,0,0
1,1674190565964524512,1,0,0,1,0,1,0,0.0,,01/22/2023 09:44 PM,0,0,0
1,1594041785694887804,5,2,2,1,0,1,0,1.0,0.0,01/22/2023 09:46 PM,0,2,0
1,1677249780879464468,1,0,0,1,0,1,0,,,01/22/2023 09:46 PM,0,0,0
1,1677249802354300978,1,0,0,1,0,1,0,,,01/22/2023 09:47 PM,0,0,0
1,1806749752967643694,7,0,0,1,0,1,0,,,05/01/2023 02:51 PM,0,0,0
1,1695777017650221152,1,0,0,1,0,1,0,0.0,,01/22/2023 09:46 PM,0,0,0
1,1674190480065178440,1,0,0,1,0,1,0,0.0,,01/22/2023 09:44 PM,0,0,0
1,1695776998116659702,1,0,0,1,0,1,0,,,01/22/2023 09:46 PM,0,0,0
1,1683527955055720452,0,1,1,1,0,1,0,0.0,0.0,01/22/2023 09:44 PM,0,1,0
1,1677249862483843200,1,3,3,1,0,1,0,0.0,0.0,01/22/2023 09:46 PM,0,3,0
1,1674190587439361020,2,0,0,1,0,1,0,0.0,,01/22/2023 09:46 PM,0,0,0
1,1677249836714039384,0,1,1,1,0,1,0,0.0,0.0,01/22/2023 09:46 PM,0,1,0
1,1695776968069880576,1,0,0,1,0,1,0,,,01/22/2023 09:46 PM,0,0,0
1,1571105050820616196,0,8,8,1,0,1,1,0.0,0.0,01/22/2023 09:46 PM,0,8,0
1,1677249828124104788,1,0,0,1,0,1,0,0.0,,01/22/2023 09:46 PM,0,0,0
1,1674190222367140226,2,0,0,1,0,1,0,0.0,,01/22/2023 09:45 PM,0,0,0
