num_bikes_available,station_id,num_docks_available,num_bikes_disabled,num_scooters_unavailable,is_renting,is_installed,is_returning,num_ebikes_available,num_docks_disabled,num_scooters_available,timestamp,n_classic,n_electric,n_scooters
3,1934290380966283526,5,7,0.0,1,1,1,0,0,0.0,07/27/2024 01:07 AM,3,0,0
5,1936553212713581016,8,2,0.0,1,1,1,1,0,0.0,07/27/2024 01:08 AM,4,1,0
9,1961472602929588766,4,1,0.0,1,1,1,6,0,1.0,07/27/2024 01:08 AM,3,6,0
5,1963359453732131538,5,1,0.0,1,1,1,0,0,0.0,07/27/2024 01:08 AM,5,0,0
10,1931696364106218226,2,2,0.0,1,1,1,6,0,1.0,07/27/2024 01:08 AM,4,6,0
4,a3ad2d57-a135-11e9-9cda-0a87ae2ba916,6,1,0.0,1,1,1,0,0,0.0,07/27/2024 01:09 AM,4,0,0
0,a3a8999a-a135-11e9-9cda-0a87ae2ba916,21,10,0.0,1,1,1,0,0,0.0,07/27/2024 01:09 AM,0,0,0
7,a3ac3b03-a135-11e9-9cda-0a87ae2ba916,3,5,0.0,1,1,1,5,0,0.0,07/27/2024 01:09 AM,2,5,0
18,a3a52df5-a135-11e9-9cda-0a87ae2ba916,5,0,0.0,1,1,1,0,0,0.0,07/27/2024 01:08 AM,18,0,0
10,a3af460f-a135-11e9-9cda-0a87ae2ba916,6,2,0.0,1,1,1,6,0,1.0,07/27/2024 01:09 AM,4,6,0
6,a3b1fa1c-a135-11e9-9cda-0a87ae2ba916,2,3,0.0,1,1,1,1,0,0.0,07/27/2024 01:09 AM,5,1,0
5,a3ad7636-a135-11e9-9cda-0a87ae2ba916,5,0,0.0,1,1,1,0,0,1.0,07/27/2024 01:09 AM,5,0,0
17,a3a5700b-a135-11e9-9cda-0a87ae2ba916,4,3,1.0,1,1,1,0,0,2.0,07/27/2024 01:09 AM,17,0,2
1,a3b3634c-a135-11e9-9cda-0a87ae2ba916,12,1,0.0,1,1,1,0,0,1.0,07/27/2024 01:09 AM,1,0,1
4,a3b0fae6-a135-11e9-9cda-0a87ae2ba916,11,0,0.0,1,1,1,1,0,0.0,07/27/2024 01:09 AM,3,1,0
4,a3a8804b-a135-11e9-9cda-0a87ae2ba916,13,1,0.0,1,1,1,0,0,0.0,07/27/2024 01:09 AM,4,0,0
4,a3a3b731-a135-11e9-9cda-0a87ae2ba916,18,0,0.0,1,1,1,3,0,2.0,07/27/2024 01:09 AM,1,3,1
12,a3a83ba1-a135-11e9-9cda-0a87ae2ba916,6,0,0.0,1,1,1,1,0,2.0,07/27/2024 01:09 AM,11,1,0
2,a3acb1de-a135-11e9-9cda-0a87ae2ba916,9,0,0.0,1,1,1,1,0,0.0,07/27/2024 01:09 AM,1,1,0
9,a3af2737-a135-11e9-9cda-0a87ae2ba916,4,1,0.0,1,1,1,0,0,1.0,07/27/2024 01:09 AM,9,0,0
0,1871992980799203880,9,6,0.0,1,1,1,0,0,0.0,07/27/2024 01:09 AM,0,0,0
3,1929538112769137066,11,1,0.0,1,1,1,1,0,0.0,07/27/2024 01:09 AM,2,1,0
3,1869054242749504212,12,0,0.0,1,1,1,1,0,0.0,07/27/2024 01:09 AM,2,1,0
5,a3a3b202-a135-11e9-9cda-0a87ae2ba916,4,2,0.0,1,1,1,0,0,4.0,07/27/2024 01:09 AM,5,0,4
11,a3aaa68b-a135-11e9-9cda-0a87ae2ba916,7,1,0.0,1,1,1,5,0,0.0,07/27/2024 01:09 AM,6,5,0
10,a3aa4017-a135-11e9-9cda-0a87ae2ba916,0,5,0.0,1,1,1,4,0,0.0,07/27/2024 01:09 AM,6,4,0
3,a3aa0bb7-a135-11e9-9cda-0a87ae2ba916,5,5,0.0,1,1,1,2,0,2.0,07/27/2024 01:09 AM,1,2,0
12,a3a859c4-a135-11e9-9cda-0a87ae2ba916,5,0,1.0,1,1,1,2,0,1.0,07/27/2024 01:09 AM,10,2,1
1,a3b22d3d-a135-11e9-9cda-0a87ae2ba916,9,1,0.0,1,1,1,0,0,0.0,07/27/2024 01:09 AM,1,0,0
0,a3acdae2-a135-11e9-9cda-0a87ae2ba916,2,9,0.0,1,1,1,0,0,0.0,07/27/2024 01:09 AM,0,0,0
6,a3a565b1-a135-11e9-9cda-0a87ae2ba916,13,0,0.0,1,1,1,2,0,0.0,07/27/2024 01:09 AM,4,2,0
9,1867616662773391950,6,0,0.0,1,1,1,0,0,0.0,07/27/2024 01:09 AM,9,0,0
19,a3ac9d43-a135-11e9-9cda-0a87ae2ba916,2,0,1.0,1,1,1,6,0,1.0,07/27/2024 01:09 AM,13,6,0
14,a3b419d9-a135-11e9-9cda-0a87ae2ba916,0,0,0.0,1,1,1,7,0,1.0,07/27/2024 01:09 AM,7,7,1
7,1929967657204564894,5,3,0.0,1,1,1,6,0,0.0,07/27/2024 01:09 AM,1,6,0
11,a3b01a86-a135-11e9-9cda-0a87ae2ba916,0,2,0.0,1,1,1,3,0,2.0,07/27/2024 01:09 AM,8,3,0
4,792ceba0-564f-4a2c-bcb5-90da781ffeef,10,1,0.0,1,1,1,0,0,0.0,07/27/2024 01:09 AM,4,0,0
4,1929905600854819414,11,0,0.0,1,1,1,0,0,0.0,07/27/2024 01:09 AM,4,0,0
5,a3b3915a-a135-11e9-9cda-0a87ae2ba916,1,0,0.0,1,1,1,1,0,13.0,07/27/2024 01:09 AM,4,1,13
9,1942118582722085548,3,3,0.0,1,1,1,7,0,0.0,07/27/2024 01:09 AM,2,7,0
1,ff21c158-de98-46c6-9ef7-7082bdb7c634,12,2,0.0,1,1,1,0,0,0.0,07/27/2024 01:09 AM,1,0,0
12,1934289944388426278,3,0,0.0,1,1,1,8,0,0.0,07/27/2024 01:08 AM,4,8,0
4,1963671811736140038,10,1,0.0,1,1,1,0,0,0.0,07/27/2024 01:08 AM,4,0,0
1,a3b1d532-a135-11e9-9cda-0a87ae2ba916,9,1,0.0,1,1,1,0,0,0.0,07/27/2024 01:09 AM,1,0,0
4,1943244109954931024,9,2,0.0,1,1,1,3,0,0.0,07/27/2024 01:09 AM,1,3,0
10,f0f9f5dc-3d3f-4a32-aa3e-b87566e44de9,5,0,0.0,1,1,1,1,0,0.0,07/27/2024 01:09 AM,9,1,0
3,a3a547b8-a135-11e9-9cda-0a87ae2ba916,12,0,0.0,1,1,1,1,0,0.0,07/27/2024 01:09 AM,2,1,0
6,a3a96aca-a135-11e9-9cda-0a87ae2ba916,5,0,0.0,1,1,1,0,0,0.0,07/27/2024 01:09 AM,6,0,0
11,a3af52bc-a135-11e9-9cda-0a87ae2ba916,5,6,0.0,1,1,1,6,0,1.0,07/27/2024 01:09 AM,5,6,0
4,a3ad95a7-a135-11e9-9cda-0a87ae2ba916,9,2,0.0,1,1,1,0,0,0.0,07/27/2024 01:09 AM,4,0,0
13,a3a8855c-a135-11e9-9cda-0a87ae2ba916,6,4,0.0,1,1,1,2,0,2.0,07/27/2024 01:09 AM,11,2,0
4,a3af9a83-a135-11e9-9cda-0a87ae2ba916,10,1,0.0,1,1,1,2,0,0.0,07/27/2024 01:09 AM,2,2,0
1,a3b23785-a135-11e9-9cda-0a87ae2ba916,7,3,0.0,1,1,1,0,0,0.0,07/27/2024 01:09 AM,1,0,0
9,a3a3f0c6-a135-11e9-9cda-0a87ae2ba916,6,0,0.0,1,1,1,0,0,0.0,07/27/2024 01:09 AM,9,0,0
3,a3a62fc9-a135-11e9-9cda-0a87ae2ba916,11,1,0.0,1,1,1,1,0,0.0,07/27/2024 01:09 AM,2,1,0
16,a3b48c07-a135-11e9-9cda-0a87ae2ba916,0,1,0.0,1,1,1,3,0,2.0,07/27/2024 01:09 AM,13,3,0
10,a3aae35a-a135-11e9-9cda-0a87ae2ba916,2,2,1.0,1,1,1,1,0,0.0,07/27/2024 01:09 AM,9,1,0
3,1879436840905128284,9,3,0.0,1,1,1,0,0,0.0,07/27/2024 01:09 AM,3,0,0
3,a3a5a9d0-a135-11e9-9cda-0a87ae2ba916,14,1,0.0,1,1,1,2,0,1.0,07/27/2024 01:09 AM,1,2,0
12,a3afb401-a135-11e9-9cda-0a87ae2ba916,1,2,0.0,1,1,1,7,0,0.0,07/27/2024 01:09 AM,5,7,0
9,a3a75885-a135-11e9-9cda-0a87ae2ba916,14,1,0.0,1,1,1,2,0,0.0,07/27/2024 01:09 AM,7,2,0
2,a3b477ac-a135-11e9-9cda-0a87ae2ba916,10,2,0.0,1,1,1,0,0,1.0,07/27/2024 01:09 AM,2,0,0
11,a3a79adb-a135-11e9-9cda-0a87ae2ba916,13,0,0.0,1,1,1,0,0,4.0,07/27/2024 01:09 AM,11,0,3
1,94788869-1849-43f6-99e1-2eacbc3fab03,15,2,1.0,1,1,1,0,1,0.0,07/27/2024 01:09 AM,1,0,0
2,1890605196211329420,2,3,0.0,1,1,1,1,0,8.0,07/27/2024 01:09 AM,1,1,0
5,a3a59ec3-a135-11e9-9cda-0a87ae2ba916,11,2,0.0,1,1,1,0,0,1.0,07/27/2024 01:09 AM,5,0,1
0,a3b20960-a135-11e9-9cda-0a87ae2ba916,4,3,0.0,1,1,1,0,0,0.0,07/27/2024 01:09 AM,0,0,0
0,a3b13e66-a135-11e9-9cda-0a87ae2ba916,10,0,0.0,1,1,1,0,0,1.0,07/27/2024 01:09 AM,0,0,0
4,a3b2be3a-a135-11e9-9cda-0a87ae2ba916,1,5,0.0,1,1,1,2,0,0.0,07/27/2024 01:09 AM,2,2,0
9,a3a48d5c-a135-11e9-9cda-0a87ae2ba916,12,2,0.0,1,1,1,0,0,0.0,07/27/2024 01:09 AM,9,0,0
0,430d5876-c44d-446e-ac53-065da9fb9c17,9,1,0.0,1,1,1,0,0,0.0,07/27/2024 01:09 AM,0,0,0
4,a3af8123-a135-11e9-9cda-0a87ae2ba916,9,1,0.0,1,1,1,2,0,1.0,07/27/2024 01:09 AM,2,2,0
1,a3b222fc-a135-11e9-9cda-0a87ae2ba916,9,1,0.0,1,1,1,1,0,0.0,07/27/2024 01:09 AM,0,1,0
4,1882466626513795782,7,3,0.0,1,1,1,1,0,0.0,07/27/2024 01:09 AM,3,1,0
8,a3ad4d1b-a135-11e9-9cda-0a87ae2ba916,7,0,0.0,1,1,1,0,0,0.0,07/27/2024 01:10 AM,8,0,0
11,a3a614ad-a135-11e9-9cda-0a87ae2ba916,13,3,1.0,1,1,1,2,0,2.0,07/27/2024 01:10 AM,9,2,2
11,a3a5d3bb-a135-11e9-9cda-0a87ae2ba916,3,0,0.0,1,1,1,4,0,1.0,07/27/2024 01:10 AM,7,4,1
11,a3a5de24-a135-11e9-9cda-0a87ae2ba916,2,2,0.0,1,1,1,4,0,0.0,07/27/2024 01:10 AM,7,4,0
1,a3ac35ed-a135-11e9-9cda-0a87ae2ba916,0,0,0.0,0,1,0,1,10,0.0,07/27/2024 01:10 AM,0,0,0
3,a3a9f76a-a135-11e9-9cda-0a87ae2ba916,12,0,0.0,1,1,1,0,0,0.0,07/27/2024 01:10 AM,3,0,0
1,a3b24701-a135-11e9-9cda-0a87ae2ba916,8,2,0.0,1,1,1,1,0,0.0,07/27/2024 01:10 AM,0,1,0
30,1862806445904101456,3,6,0.0,1,1,1,3,0,0.0,07/27/2024 01:10 AM,27,3,0
5,1934289361049585738,6,0,0.0,1,1,1,1,0,4.0,07/27/2024 01:10 AM,4,1,0
10,a3a3e67b-a135-11e9-9cda-0a87ae2ba916,15,2,0.0,1,1,1,0,0,3.0,07/27/2024 01:10 AM,10,0,3
6,1928792940289520096,8,0,0.0,1,1,1,3,0,1.0,07/27/2024 01:10 AM,3,3,0
1,a3b148bf-a135-11e9-9cda-0a87ae2ba916,9,1,0.0,1,1,1,1,0,0.0,07/27/2024 01:10 AM,0,1,0
4,e63300bd-4ca3-4255-adfd-522289d68b8a,9,2,0.0,1,1,1,1,0,0.0,07/27/2024 01:10 AM,3,1,0
16,a3a3a282-a135-11e9-9cda-0a87ae2ba916,19,0,0.0,1,1,1,4,0,0.0,07/27/2024 01:10 AM,12,4,0
4,1943245395846580390,10,0,0.0,1,1,1,0,0,0.0,07/27/2024 01:10 AM,4,0,0
5,1963672425916463636,10,0,0.0,1,1,1,0,0,0.0,07/27/2024 01:10 AM,5,0,0
8,a3a82c6c-a135-11e9-9cda-0a87ae2ba916,11,3,0.0,1,1,1,1,0,1.0,07/27/2024 01:10 AM,7,1,0
1,a3b2862e-a135-11e9-9cda-0a87ae2ba916,7,3,0.0,1,1,1,0,0,0.0,07/27/2024 01:10 AM,1,0,0
1,1967727360320698512,10,0,0.0,1,1,1,1,0,4.0,07/27/2024 01:10 AM,0,1,0
7,a3a76cb6-a135-11e9-9cda-0a87ae2ba916,4,1,0.0,1,1,1,4,0,3.0,07/27/2024 01:10 AM,3,4,0
15,a3a80512-a135-11e9-9cda-0a87ae2ba916,3,0,0.0,1,1,1,1,0,0.0,07/27/2024 01:10 AM,14,1,0
3,a3b11480-a135-11e9-9cda-0a87ae2ba916,8,0,0.0,1,1,1,0,0,0.0,07/27/2024 01:10 AM,3,0,0
8,1936552461714393094,7,0,0.0,1,1,1,2,0,0.0,07/27/2024 01:10 AM,6,2,0
4,90011328-f7bd-4b7b-8f95-8204a0b50f27,4,2,1.0,1,1,1,0,0,0.0,07/27/2024 01:10 AM,4,0,0
4,a3a5f5e6-a135-11e9-9cda-0a87ae2ba916,6,1,0.0,1,1,1,3,0,0.0,07/27/2024 01:10 AM,1,3,0
5,1934288718318207280,6,2,0.0,1,1,1,3,0,2.0,07/27/2024 01:10 AM,2,3,0
5,a21de1a5-f5bc-4b50-8a13-aa28b7dcfa95,10,0,0.0,1,1,1,0,0,0.0,07/27/2024 01:10 AM,5,0,0
10,a3aabad8-a135-11e9-9cda-0a87ae2ba916,4,2,0.0,1,1,1,2,0,3.0,07/27/2024 01:10 AM,8,2,0
0,a3a75d8a-a135-11e9-9cda-0a87ae2ba916,13,7,0.0,1,1,1,0,0,0.0,07/27/2024 01:10 AM,0,0,0
2,a3ac1607-a135-11e9-9cda-0a87ae2ba916,12,0,0.0,1,1,1,1,0,1.0,07/27/2024 01:10 AM,1,1,1
5,1958859639339458778,7,2,0.0,1,1,1,0,0,1.0,07/27/2024 01:10 AM,5,0,0
4,a3afbe2e-a135-11e9-9cda-0a87ae2ba916,10,0,1.0,1,1,1,0,0,0.0,07/27/2024 01:10 AM,4,0,0
8,a3ac7444-a135-11e9-9cda-0a87ae2ba916,7,0,0.0,1,1,1,0,0,0.0,07/27/2024 01:10 AM,8,0,0
4,a3b29fae-a135-11e9-9cda-0a87ae2ba916,6,1,0.0,1,1,1,1,0,0.0,07/27/2024 01:10 AM,3,1,0
12,a3af2c5f-a135-11e9-9cda-0a87ae2ba916,7,0,0.0,1,1,1,9,0,0.0,07/27/2024 01:10 AM,3,9,0
8,a3a62aad-a135-11e9-9cda-0a87ae2ba916,9,0,0.0,1,1,1,0,0,2.0,07/27/2024 01:10 AM,8,0,2
4,a3acea44-a135-11e9-9cda-0a87ae2ba916,7,0,0.0,1,1,1,3,0,0.0,07/27/2024 01:10 AM,1,3,0
3,a3a528d0-a135-11e9-9cda-0a87ae2ba916,4,4,0.0,1,1,1,0,0,0.0,07/27/2024 01:10 AM,3,0,0
6,a3ac30c5-a135-11e9-9cda-0a87ae2ba916,9,0,0.0,1,1,1,0,0,0.0,07/27/2024 01:10 AM,6,0,0
1,da9e6779-5056-4d45-bae3-9dc325ed2807,9,1,0.0,1,1,1,0,0,0.0,07/27/2024 01:10 AM,1,0,0
2,a3a72012-a135-11e9-9cda-0a87ae2ba916,6,2,0.0,1,1,1,0,0,1.0,07/27/2024 01:10 AM,2,0,1
2,a3a965b2-a135-11e9-9cda-0a87ae2ba916,13,0,0.0,1,1,1,0,0,0.0,07/27/2024 01:10 AM,2,0,0
1,a3b2905a-a135-11e9-9cda-0a87ae2ba916,9,1,0.0,1,1,1,0,0,0.0,07/27/2024 01:10 AM,1,0,0
3,a3ac7e9a-a135-11e9-9cda-0a87ae2ba916,8,3,0.0,1,1,1,0,0,1.0,07/27/2024 01:10 AM,3,0,1
3,a3aa8ca0-a135-11e9-9cda-0a87ae2ba916,8,3,0.0,1,1,1,1,0,1.0,07/27/2024 01:10 AM,2,1,0
4,a3a795d7-a135-11e9-9cda-0a87ae2ba916,15,0,0.0,1,1,1,0,0,0.0,07/27/2024 01:10 AM,4,0,0
3,a3ad13e4-a135-11e9-9cda-0a87ae2ba916,7,0,0.0,1,1,1,0,0,1.0,07/27/2024 01:10 AM,3,0,1
3,1929883678185797908,5,4,0.0,1,1,1,3,0,3.0,07/27/2024 01:10 AM,0,3,0
7,759171ce-f355-4740-948d-e14bb8f7dc0e,8,0,0.0,1,1,1,4,0,0.0,07/27/2024 01:10 AM,3,4,0
3,a3b10a40-a135-11e9-9cda-0a87ae2ba916,8,0,0.0,1,1,1,0,0,0.0,07/27/2024 01:10 AM,3,0,0
13,a3a99d47-a135-11e9-9cda-0a87ae2ba916,8,1,0.0,1,1,1,2,0,1.0,07/27/2024 01:10 AM,11,2,1
5,4843d153-c725-4230-a4c7-402da6a62143,7,1,0.0,1,1,1,2,0,2.0,07/27/2024 01:10 AM,3,2,0
3,1955905507044284968,11,1,0.0,1,1,1,0,0,0.0,07/27/2024 01:10 AM,3,0,0
7,1942117929887056608,5,3,0.0,1,1,1,3,0,0.0,07/27/2024 01:10 AM,4,3,0
6,a3a9c0f6-a135-11e9-9cda-0a87ae2ba916,3,2,0.0,1,1,1,2,0,0.0,07/27/2024 01:10 AM,4,2,0
4,a3a97a01-a135-11e9-9cda-0a87ae2ba916,7,3,0.0,1,1,1,4,0,1.0,07/27/2024 01:10 AM,0,4,1
9,1799277526470631980,0,1,0.0,1,1,1,4,0,2.0,07/27/2024 01:10 AM,5,7,0
12,a3b00b3a-a135-11e9-9cda-0a87ae2ba916,1,0,0.0,1,1,1,4,0,2.0,07/27/2024 01:10 AM,8,4,0
3,a3b481e1-a135-11e9-9cda-0a87ae2ba916,10,2,0.0,1,1,1,2,0,0.0,07/27/2024 01:10 AM,1,2,0
6,a3a9c5f7-a135-11e9-9cda-0a87ae2ba916,0,0,0.0,1,1,1,5,0,1.0,07/27/2024 01:10 AM,1,5,0
4,a3b4399a-a135-11e9-9cda-0a87ae2ba916,11,0,0.0,1,1,1,0,0,0.0,07/27/2024 01:10 AM,4,0,0
4,a3af5d1c-a135-11e9-9cda-0a87ae2ba916,9,1,0.0,1,1,1,1,0,1.0,07/27/2024 01:10 AM,3,1,0
8,a3ae87fa-a135-11e9-9cda-0a87ae2ba916,13,2,0.0,1,1,1,1,0,0.0,07/27/2024 01:10 AM,7,1,0
6,1938034236347042306,2,7,0.0,1,1,1,1,0,0.0,07/27/2024 01:10 AM,5,1,0
3,a60781db-2bec-4a15-a4a2-363297aefcec,11,1,0.0,1,1,1,1,0,0.0,07/27/2024 01:10 AM,2,1,0
4,a3b1c47b-a135-11e9-9cda-0a87ae2ba916,6,1,0.0,1,1,1,0,0,0.0,07/27/2024 01:10 AM,4,0,0
5,a3b47cbc-a135-11e9-9cda-0a87ae2ba916,7,0,0.0,1,1,1,3,0,3.0,07/27/2024 01:10 AM,2,3,3
3,a3afd7ab-a135-11e9-9cda-0a87ae2ba916,10,1,0.0,1,1,1,1,0,0.0,07/27/2024 01:10 AM,2,1,0
4,a3addda0-a135-11e9-9cda-0a87ae2ba916,7,0,0.0,1,1,1,2,0,0.0,07/27/2024 01:10 AM,2,2,0
7,a3a3ace6-a135-11e9-9cda-0a87ae2ba916,1,2,0.0,1,1,1,1,0,4.0,07/27/2024 01:10 AM,6,1,4
4,a3b2d2b7-a135-11e9-9cda-0a87ae2ba916,6,1,0.0,1,1,1,0,0,0.0,07/27/2024 01:10 AM,4,0,0
13,a3a854bf-a135-11e9-9cda-0a87ae2ba916,0,1,0.0,1,1,1,3,0,1.0,07/27/2024 01:10 AM,10,3,1
7,a3a62566-a135-11e9-9cda-0a87ae2ba916,9,1,0.0,1,1,1,0,0,2.0,07/27/2024 01:10 AM,7,0,2
9,a3b2c87c-a135-11e9-9cda-0a87ae2ba916,5,1,0.0,1,1,1,3,0,0.0,07/27/2024 01:10 AM,6,3,0
4,1850868044363584392,10,1,0.0,1,1,1,0,0,0.0,07/27/2024 01:10 AM,4,0,0
2,a3ab86b6-a135-11e9-9cda-0a87ae2ba916,19,2,0.0,1,1,1,0,0,0.0,07/27/2024 01:10 AM,2,0,0
9,a3a6c38e-a135-11e9-9cda-0a87ae2ba916,5,4,0.0,1,1,1,0,0,0.0,07/27/2024 01:10 AM,9,0,0
3,a3a9b1d7-a135-11e9-9cda-0a87ae2ba916,7,2,0.0,1,1,1,0,0,3.0,07/27/2024 01:10 AM,3,0,3
1,1943244520961310788,11,1,0.0,1,1,1,1,0,2.0,07/27/2024 01:10 AM,0,1,0
5,1850866657089146912,14,0,0.0,1,1,1,1,0,0.0,07/27/2024 01:10 AM,4,1,0
4,1969221526359528022,15,0,0.0,1,1,1,1,0,0.0,07/27/2024 01:10 AM,3,1,0
4,1936582560225114270,8,3,0.0,1,1,1,0,0,0.0,07/27/2024 01:10 AM,4,0,0
2,1966307477149012058,4,1,0.0,1,1,1,0,0,4.0,07/27/2024 01:10 AM,2,0,0
4,1969236968943731106,11,0,0.0,1,1,1,2,0,0.0,07/27/2024 01:10 AM,2,2,0
4,a3a7f0ba-a135-11e9-9cda-0a87ae2ba916,10,1,0.0,1,1,1,1,0,0.0,07/27/2024 01:10 AM,3,1,0
9,a3afd294-a135-11e9-9cda-0a87ae2ba916,5,1,0.0,1,1,1,3,0,0.0,07/27/2024 01:10 AM,6,3,0
2,a3b2d7d9-a135-11e9-9cda-0a87ae2ba916,7,2,0.0,1,1,1,0,0,0.0,07/27/2024 01:10 AM,2,0,0
0,a3ad8072-a135-11e9-9cda-0a87ae2ba916,31,0,,1,1,1,0,0,,07/27/2024 01:10 AM,0,0,0
11,1871993715238611622,1,0,0.0,1,1,1,2,0,3.0,07/27/2024 01:10 AM,9,2,0
20,a3a4ac3f-a135-11e9-9cda-0a87ae2ba916,5,1,0.0,1,1,1,0,0,1.0,07/27/2024 01:10 AM,20,0,0
2,a3b23cb8-a135-11e9-9cda-0a87ae2ba916,7,2,0.0,1,1,1,0,0,0.0,07/27/2024 01:10 AM,2,0,0
19,a3aa35a4-a135-11e9-9cda-0a87ae2ba916,12,0,0.0,1,1,1,0,0,0.0,07/27/2024 01:10 AM,19,0,0
10,a3a497b6-a135-11e9-9cda-0a87ae2ba916,7,0,0.0,1,1,1,1,0,3.0,07/27/2024 01:10 AM,9,1,1
3,a3b13836-a135-11e9-9cda-0a87ae2ba916,7,1,0.0,1,1,1,0,0,0.0,07/27/2024 01:10 AM,3,0,0
3,a3ab9119-a135-11e9-9cda-0a87ae2ba916,42,1,0.0,1,1,1,0,0,1.0,07/27/2024 01:10 AM,3,0,0
8,a3a41004-a135-11e9-9cda-0a87ae2ba916,2,3,0.0,1,1,1,0,0,1.0,07/27/2024 01:10 AM,8,0,0
2,1945195957167804800,13,0,0.0,1,1,1,0,0,0.0,07/27/2024 01:10 AM,2,0,0
2,1963673207600511026,12,1,0.0,1,1,1,0,0,0.0,07/27/2024 01:10 AM,2,0,0
8,732c9f35-0c82-4128-acc3-2cf447298b1d,7,0,0.0,1,1,1,0,0,0.0,07/27/2024 01:10 AM,8,0,0
1,1933998036428004326,14,0,0.0,1,1,1,0,0,0.0,07/27/2024 01:10 AM,1,0,0
0,1970688521031469268,15,0,,1,1,1,0,0,,07/27/2024 01:10 AM,0,0,0
6,1934289130932983934,8,1,0.0,1,1,1,1,0,0.0,07/27/2024 01:10 AM,5,1,0
5,a3b26acf-a135-11e9-9cda-0a87ae2ba916,2,4,0.0,1,1,1,1,0,0.0,07/27/2024 01:09 AM,4,1,0
15,a3a88f84-a135-11e9-9cda-0a87ae2ba916,0,4,0.0,1,1,1,2,0,0.0,07/27/2024 01:09 AM,13,2,0
9,a3aca790-a135-11e9-9cda-0a87ae2ba916,15,0,0.0,1,1,1,4,0,2.0,07/27/2024 01:09 AM,5,4,0
6,a3b21de7-a135-11e9-9cda-0a87ae2ba916,3,2,0.0,1,1,1,0,0,0.0,07/27/2024 01:09 AM,6,0,0
9,1926982189560422428,6,0,0.0,1,1,1,3,0,0.0,07/27/2024 01:09 AM,6,3,0
1,a3aca268-a135-11e9-9cda-0a87ae2ba916,10,0,0.0,1,1,1,0,0,0.0,07/27/2024 01:09 AM,1,0,0
4,a3b0eb93-a135-11e9-9cda-0a87ae2ba916,6,1,0.0,1,1,1,0,0,0.0,07/27/2024 01:09 AM,4,0,0
2,1943240055911940522,12,1,0.0,1,1,1,1,0,0.0,07/27/2024 01:09 AM,1,1,0
3,a3b1efd6-a135-11e9-9cda-0a87ae2ba916,7,0,0.0,1,1,1,3,0,1.0,07/27/2024 01:09 AM,0,3,0
4,1936582264492460636,9,2,0.0,1,1,1,2,0,0.0,07/27/2024 01:09 AM,2,2,0
0,a3a42574-a135-11e9-9cda-0a87ae2ba916,34,1,0.0,1,1,1,0,0,0.0,07/27/2024 01:09 AM,0,0,0
7,a3ac7978-a135-11e9-9cda-0a87ae2ba916,1,2,0.0,1,1,1,3,0,1.0,07/27/2024 01:09 AM,4,3,1
5,8fd03909-317e-4b6c-b8e9-f4c28b4c90b1,9,1,0.0,1,1,1,1,0,0.0,07/27/2024 01:09 AM,4,1,0
14,a3a4f993-a135-11e9-9cda-0a87ae2ba916,1,0,0.0,1,1,1,3,0,4.0,07/27/2024 01:09 AM,11,3,4
3,c1f104db-9ee7-4999-bd4a-ddd766c75e04,7,1,0.0,1,1,1,1,0,0.0,07/27/2024 01:09 AM,2,1,0
5,1861613253877461614,8,2,0.0,1,1,1,0,0,0.0,07/27/2024 01:09 AM,5,0,0
4,c4040b17-88bd-40ab-9aae-2655d6771580,11,0,0.0,1,1,1,0,0,0.0,07/27/2024 01:09 AM,4,0,0
4,1870208802121658482,11,0,0.0,1,1,1,0,0,0.0,07/27/2024 01:09 AM,4,0,0
6,1872721624592814362,3,6,0.0,1,1,1,4,0,0.0,07/27/2024 01:09 AM,2,4,0
6,a3b1ff34-a135-11e9-9cda-0a87ae2ba916,4,1,0.0,1,1,1,0,0,0.0,07/27/2024 01:09 AM,6,0,0
13,a3a3eb9a-a135-11e9-9cda-0a87ae2ba916,5,1,0.0,1,1,1,2,0,0.0,07/27/2024 01:09 AM,11,2,0
8,1929121088624564460,6,1,0.0,1,1,1,4,0,0.0,07/27/2024 01:09 AM,4,4,0
7,b43a9764-2b1d-4fa0-a13f-7e05eddc7fcd,15,1,0.0,1,1,1,0,0,0.0,07/27/2024 01:09 AM,7,0,0
9,a3ac2671-a135-11e9-9cda-0a87ae2ba916,3,2,0.0,1,1,1,1,0,1.0,07/27/2024 01:09 AM,8,1,0
13,a3a5a48b-a135-11e9-9cda-0a87ae2ba916,6,0,0.0,1,1,1,0,0,0.0,07/27/2024 01:09 AM,13,0,0
9,a3b00055-a135-11e9-9cda-0a87ae2ba916,4,1,0.0,1,1,1,5,0,1.0,07/27/2024 01:09 AM,4,5,0
5,a3b35885-a135-11e9-9cda-0a87ae2ba916,5,0,0.0,1,1,1,3,0,1.0,07/27/2024 01:09 AM,2,3,0
12,a3aab5c1-a135-11e9-9cda-0a87ae2ba916,4,2,0.0,1,1,1,4,0,1.0,07/27/2024 01:09 AM,8,4,0
4,a3b0d6ec-a135-11e9-9cda-0a87ae2ba916,2,5,0.0,1,1,1,2,0,0.0,07/27/2024 01:09 AM,2,2,0
7,1932496568454183892,8,0,0.0,1,1,1,4,0,0.0,07/27/2024 01:09 AM,3,4,0
10,1930641272056945296,3,2,0.0,1,1,1,7,0,0.0,07/27/2024 01:09 AM,3,7,0
3,a3b218cd-a135-11e9-9cda-0a87ae2ba916,8,0,0.0,1,1,1,0,0,0.0,07/27/2024 01:09 AM,3,0,0
0,a3af2216-a135-11e9-9cda-0a87ae2ba916,5,3,0.0,1,1,1,0,0,3.0,07/27/2024 01:09 AM,0,0,0
2,a3a89488-a135-11e9-9cda-0a87ae2ba916,16,1,0.0,1,1,1,2,0,0.0,07/27/2024 01:09 AM,0,2,0
7,a3a7d279-a135-11e9-9cda-0a87ae2ba916,1,0,0.0,1,1,1,1,0,3.0,07/27/2024 01:09 AM,6,1,3
4,1890603435601779460,10,1,0.0,1,1,1,0,0,0.0,07/27/2024 01:09 AM,4,0,0
3,a3b11993-a135-11e9-9cda-0a87ae2ba916,8,0,0.0,1,1,1,0,0,0.0,07/27/2024 01:09 AM,3,0,0
4,a3acd5b1-a135-11e9-9cda-0a87ae2ba916,4,3,0.0,1,1,1,1,0,0.0,07/27/2024 01:09 AM,3,1,0
1,1958859209051740602,12,0,0.0,1,1,1,0,0,2.0,07/27/2024 01:08 AM,1,0,0
5,1965904499533560722,2,3,0.0,1,1,1,3,0,1.0,07/27/2024 01:08 AM,2,3,0
11,a3aa91f4-a135-11e9-9cda-0a87ae2ba916,0,2,0.0,1,1,1,0,0,1.0,07/27/2024 01:09 AM,11,0,0
4,a77136ee-060b-433b-88d0-ec74af1ef7ad,10,1,0.0,1,1,1,0,0,0.0,07/27/2024 01:09 AM,4,0,0
4,a3b25656-a135-11e9-9cda-0a87ae2ba916,6,1,0.0,1,1,1,0,0,0.0,07/27/2024 01:09 AM,4,0,0
6,1861588043429399408,4,0,0.0,1,1,1,3,0,1.0,07/27/2024 01:09 AM,3,3,0
7,a3a9acc5-a135-11e9-9cda-0a87ae2ba916,4,0,0.0,1,1,1,1,0,1.0,07/27/2024 01:10 AM,6,1,0
6,a3a7cd56-a135-11e9-9cda-0a87ae2ba916,9,0,0.0,1,1,1,1,0,0.0,07/27/2024 01:09 AM,5,1,0
3,a3adbedf-a135-11e9-9cda-0a87ae2ba916,8,0,0.0,1,1,1,0,0,0.0,07/27/2024 01:09 AM,3,0,0
4,1969204473221170122,11,0,0.0,1,1,1,1,0,0.0,07/27/2024 01:09 AM,3,1,0
1,1970390432459950744,14,0,0.0,1,1,1,1,0,0.0,07/27/2024 01:09 AM,0,1,0
11,a3ab8bee-a135-11e9-9cda-0a87ae2ba916,2,1,0.0,1,1,1,3,0,1.0,07/27/2024 01:10 AM,8,3,0
12,a3b0d1d5-a135-11e9-9cda-0a87ae2ba916,0,7,0.0,1,1,1,4,0,0.0,07/27/2024 01:09 AM,8,4,0
3,1872721263815561908,11,1,0.0,1,1,1,3,0,0.0,07/27/2024 01:09 AM,0,3,0
3,1871990322214447924,7,4,0.0,1,1,1,0,0,1.0,07/27/2024 01:10 AM,3,0,0
6,a3a5af44-a135-11e9-9cda-0a87ae2ba916,4,0,0.0,1,1,1,1,0,5.0,07/27/2024 01:10 AM,5,1,5
7,1929121521556988340,8,0,0.0,1,1,1,0,0,0.0,07/27/2024 01:10 AM,7,0,0
3,1934290793283144612,9,3,0.0,1,1,1,1,0,0.0,07/27/2024 01:07 AM,2,1,0
2,a3add889-a135-11e9-9cda-0a87ae2ba916,9,0,0.0,1,1,1,0,0,0.0,07/27/2024 01:09 AM,2,0,0
3,625e37ea-24ea-4f13-9a54-6322466ec521,9,3,0.0,1,1,1,0,0,0.0,07/27/2024 01:09 AM,3,0,0
1,1934290608103817582,14,0,0.0,1,1,1,1,0,0.0,07/27/2024 01:09 AM,0,1,0
5,a3afc347-a135-11e9-9cda-0a87ae2ba916,13,1,0.0,1,1,1,2,0,0.0,07/27/2024 01:09 AM,3,2,0
3,a3b300d3-a135-11e9-9cda-0a87ae2ba916,11,1,0.0,1,1,1,1,0,0.0,07/27/2024 01:09 AM,2,1,0
3,a065d29d-a081-47f4-8d0f-9a572f6085fe,12,0,0.0,1,1,1,1,0,0.0,07/27/2024 01:09 AM,2,1,0
4,a3ac4548-a135-11e9-9cda-0a87ae2ba916,8,3,0.0,1,1,1,1,0,0.0,07/27/2024 01:09 AM,3,1,0
4,a3a6f7a5-a135-11e9-9cda-0a87ae2ba916,26,4,1.0,1,1,1,2,0,0.0,07/27/2024 01:09 AM,2,2,0
2,a3a45e3b-a135-11e9-9cda-0a87ae2ba916,34,3,0.0,1,1,1,0,0,0.0,07/27/2024 01:09 AM,2,0,0
7,391d5cd8-c87c-42f8-94df-823f94284005,6,2,0.0,1,1,1,1,0,0.0,07/27/2024 01:09 AM,6,1,0
1,a3b3820c-a135-11e9-9cda-0a87ae2ba916,13,4,0.0,1,1,1,1,0,1.0,07/27/2024 01:09 AM,0,1,1
5,a3a6e359-a135-11e9-9cda-0a87ae2ba916,9,1,0.0,1,1,1,0,0,0.0,07/27/2024 01:09 AM,5,0,0
5,22afe78c-e8f7-4a80-969e-7ddeafdf49da,9,1,0.0,1,1,1,3,0,0.0,07/27/2024 01:09 AM,2,3,0
13,a3b0f0b6-a135-11e9-9cda-0a87ae2ba916,1,1,0.0,1,1,1,8,0,0.0,07/27/2024 01:09 AM,5,8,0
4,1863873701095594368,11,0,0.0,1,1,1,0,0,0.0,07/27/2024 01:09 AM,4,0,0
13,a3a8711c-a135-11e9-9cda-0a87ae2ba916,4,0,0.0,1,1,1,12,0,2.0,07/27/2024 01:09 AM,1,12,2
1,1850867138125484782,10,0,0.0,1,1,1,0,0,0.0,07/27/2024 01:10 AM,1,0,0
12,a3aff616-a135-11e9-9cda-0a87ae2ba916,1,2,0.0,1,1,1,5,0,0.0,07/27/2024 01:10 AM,7,5,0
0,a3a7dc8c-a135-11e9-9cda-0a87ae2ba916,17,1,0.0,1,1,1,0,0,1.0,07/27/2024 01:10 AM,0,0,1
13,a3b3686c-a135-11e9-9cda-0a87ae2ba916,2,0,0.0,1,1,1,3,0,0.0,07/27/2024 01:10 AM,10,3,0
4,c3f1be96-07c2-4c65-8a1d-f2203de88495,5,6,0.0,1,1,1,0,0,0.0,07/27/2024 01:10 AM,4,0,0
6,87d2a090-22cd-471b-b622-fef3923999dd,9,0,0.0,1,1,1,0,0,0.0,07/27/2024 01:10 AM,6,0,0
2,a3ad5c90-a135-11e9-9cda-0a87ae2ba916,10,1,0.0,1,1,1,1,0,2.0,07/27/2024 01:10 AM,1,1,0
5,a3a46e71-a135-11e9-9cda-0a87ae2ba916,29,1,0.0,1,1,1,1,0,0.0,07/27/2024 01:10 AM,4,1,0
0,1966306862968688728,15,0,,1,1,1,0,0,,07/27/2024 01:10 AM,0,0,0
2,a3a77c8d-a135-11e9-9cda-0a87ae2ba916,44,1,0.0,1,1,1,0,0,0.0,07/27/2024 01:10 AM,2,0,0
9,a3a771c2-a135-11e9-9cda-0a87ae2ba916,3,2,0.0,1,1,1,1,0,1.0,07/27/2024 01:10 AM,8,1,0
6,7e435d2a-617e-4c3f-bed0-a8801c20f265,9,0,0.0,1,1,1,0,0,0.0,07/27/2024 01:10 AM,6,0,0
2,1e7e4cf3-a16b-4cb7-9ead-fdd71e07ea77,12,1,0.0,1,1,1,0,0,0.0,07/27/2024 01:10 AM,2,0,0
15,a3a378ca-a135-11e9-9cda-0a87ae2ba916,6,1,0.0,1,1,1,1,0,1.0,07/27/2024 01:10 AM,14,1,1
1,1866476559603607834,1,2,0.0,1,1,1,0,0,0.0,07/27/2024 01:10 AM,1,0,0
10,a3af624c-a135-11e9-9cda-0a87ae2ba916,0,0,0.0,1,1,1,6,0,1.0,07/27/2024 01:10 AM,4,6,0
1,a3b30b06-a135-11e9-9cda-0a87ae2ba916,13,1,0.0,1,1,1,1,0,0.0,07/27/2024 01:10 AM,0,1,0
5,a3a6e866-a135-11e9-9cda-0a87ae2ba916,17,0,0.0,1,1,1,1,0,1.0,07/27/2024 01:10 AM,4,1,1
10,a3a6054c-a135-11e9-9cda-0a87ae2ba916,5,0,0.0,1,1,1,0,0,0.0,07/27/2024 01:10 AM,10,0,0
5,1867617341378224632,9,1,0.0,1,1,1,0,0,0.0,07/27/2024 01:10 AM,5,0,0
10,8995498f-1209-4b06-9317-01cd695b3b61,0,0,1.0,1,1,1,1,0,0.0,07/27/2024 01:10 AM,9,1,0
9,a3a44ec7-a135-11e9-9cda-0a87ae2ba916,7,2,0.0,1,1,1,0,0,1.0,07/27/2024 01:10 AM,9,0,1
5,1926946441362045298,9,1,0.0,1,1,1,0,0,0.0,07/27/2024 01:10 AM,5,0,0
8,a3a6fcac-a135-11e9-9cda-0a87ae2ba916,6,8,1.0,1,1,1,0,0,0.0,07/27/2024 01:10 AM,8,0,0
0,a3a57a52-a135-11e9-9cda-0a87ae2ba916,11,0,,1,1,1,0,0,,07/27/2024 01:10 AM,0,0,0
7,a3b2e20c-a135-11e9-9cda-0a87ae2ba916,7,1,0.0,1,1,1,0,0,0.0,07/27/2024 01:10 AM,7,0,0
5,a3a3a7b4-a135-11e9-9cda-0a87ae2ba916,8,1,0.0,1,1,1,2,0,1.0,07/27/2024 01:10 AM,3,2,1
1,14d6e4b0-d0cc-4ccb-b757-e596d8c24a99,13,1,0.0,1,1,1,1,0,0.0,07/27/2024 01:10 AM,0,1,0
5,a3ad42c3-a135-11e9-9cda-0a87ae2ba916,4,2,0.0,1,1,1,0,0,0.0,07/27/2024 01:10 AM,5,0,0
7,a3af956e-a135-11e9-9cda-0a87ae2ba916,5,2,0.0,1,1,1,5,0,2.0,07/27/2024 01:10 AM,2,4,0
1,a3a46896-a135-11e9-9cda-0a87ae2ba916,26,0,0.0,1,1,1,0,0,0.0,07/27/2024 01:10 AM,1,0,0
7,1929121887488481484,1,3,0.0,1,1,1,6,0,0.0,07/27/2024 01:10 AM,1,6,0
5,a3af5804-a135-11e9-9cda-0a87ae2ba916,3,1,0.0,1,1,1,2,0,2.0,07/27/2024 01:10 AM,3,2,0
6,a3a5d8db-a135-11e9-9cda-0a87ae2ba916,12,0,0.0,1,1,1,2,0,0.0,07/27/2024 01:10 AM,4,2,0
10,a3b2f698-a135-11e9-9cda-0a87ae2ba916,0,5,0.0,1,1,1,6,0,0.0,07/27/2024 01:10 AM,4,6,0
0,a3ad8aa3-a135-11e9-9cda-0a87ae2ba916,13,2,0.0,1,1,1,0,0,0.0,07/27/2024 01:10 AM,0,0,0
3,1866477298337982542,0,1,0.0,1,1,1,0,0,0.0,07/27/2024 01:10 AM,3,0,0
15,a3ad61c2-a135-11e9-9cda-0a87ae2ba916,3,1,0.0,1,1,1,2,0,0.0,07/27/2024 01:10 AM,13,2,0
11,a3a61a0b-a135-11e9-9cda-0a87ae2ba916,0,3,0.0,1,1,1,0,0,1.0,07/27/2024 01:10 AM,11,0,0
6,1936566008041245278,4,1,0.0,1,1,1,1,0,0.0,07/27/2024 01:10 AM,5,1,0
11,a3b3968b-a135-11e9-9cda-0a87ae2ba916,2,1,0.0,1,1,1,3,0,1.0,07/27/2024 01:10 AM,8,3,0
15,a3b0bd42-a135-11e9-9cda-0a87ae2ba916,0,0,0.0,1,1,1,4,0,0.0,07/27/2024 01:10 AM,11,4,0
0,a3b4728f-a135-11e9-9cda-0a87ae2ba916,11,0,,1,1,1,0,0,,07/27/2024 01:10 AM,0,0,0
10,a3a58ee0-a135-11e9-9cda-0a87ae2ba916,2,2,0.0,1,1,1,4,0,1.0,07/27/2024 01:10 AM,6,4,0
5,a3ad1e12-a135-11e9-9cda-0a87ae2ba916,9,0,0.0,1,1,1,0,0,1.0,07/27/2024 01:10 AM,5,0,1
2,a3aaca0e-a135-11e9-9cda-0a87ae2ba916,9,8,0.0,1,1,1,1,0,0.0,07/27/2024 01:10 AM,1,1,0
8,1958860355622110046,7,0,0.0,1,1,1,2,0,0.0,07/27/2024 01:10 AM,6,2,0
10,a3b22815-a135-11e9-9cda-0a87ae2ba916,0,1,0.0,1,1,1,7,0,0.0,07/27/2024 01:10 AM,3,7,0
4,1945178760530424534,9,0,0.0,1,1,1,0,0,2.0,07/27/2024 01:10 AM,4,0,0
17,a3a41526-a135-11e9-9cda-0a87ae2ba916,20,5,0.0,1,1,1,2,0,1.0,07/27/2024 01:10 AM,15,2,1
4,a3a7af11-a135-11e9-9cda-0a87ae2ba916,11,0,0.0,1,1,1,1,0,0.0,07/27/2024 01:10 AM,3,1,0
3,a3a5c440-a135-11e9-9cda-0a87ae2ba916,11,1,0.0,1,1,1,0,0,0.0,07/27/2024 01:10 AM,3,0,0
8,a3a62025-a135-11e9-9cda-0a87ae2ba916,9,0,0.0,1,1,1,0,0,2.0,07/27/2024 01:10 AM,8,0,0
2,1939906971867155378,10,2,0.0,1,1,1,1,0,1.0,07/27/2024 01:10 AM,1,1,0
4,a3b453f2-a135-11e9-9cda-0a87ae2ba916,3,0,0.0,1,1,1,1,0,0.0,07/27/2024 01:10 AM,3,1,0
6,a3a39301-a135-11e9-9cda-0a87ae2ba916,8,0,0.0,1,1,1,0,0,1.0,07/27/2024 01:10 AM,6,0,0
6,1863873159929715228,8,1,0.0,1,1,1,1,0,0.0,07/27/2024 01:10 AM,5,1,0
0,a3acacbc-a135-11e9-9cda-0a87ae2ba916,15,0,,1,1,1,0,0,,07/27/2024 01:10 AM,0,0,0
2,1871991855517771832,13,0,0.0,1,1,1,0,0,0.0,07/27/2024 01:10 AM,2,0,0
7,a3aa7373-a135-11e9-9cda-0a87ae2ba916,4,4,0.0,1,1,1,3,0,0.0,07/27/2024 01:10 AM,4,3,0
6,6fd280b0-74de-4a89-947d-3be40afa079c,5,4,0.0,1,1,1,2,0,0.0,07/27/2024 01:10 AM,4,2,0
2,a3b241df-a135-11e9-9cda-0a87ae2ba916,4,1,0.0,1,1,1,1,0,0.0,07/27/2024 01:10 AM,1,1,0
9,a3a866a5-a135-11e9-9cda-0a87ae2ba916,3,7,0.0,1,1,1,2,0,0.0,07/27/2024 01:10 AM,7,2,0
14,a3b38728-a135-11e9-9cda-0a87ae2ba916,8,1,0.0,1,1,1,4,0,0.0,07/27/2024 01:10 AM,10,4,0
0,a3ad7b51-a135-11e9-9cda-0a87ae2ba916,7,2,0.0,1,1,1,0,0,1.0,07/27/2024 01:10 AM,0,0,0
4,a3b45e26-a135-11e9-9cda-0a87ae2ba916,2,0,1.0,1,1,1,0,0,4.0,07/27/2024 01:10 AM,4,0,0
5,1754781885939323186,3,3,0.0,1,1,1,1,0,0.0,07/27/2024 01:10 AM,4,1,0
7,9e5ce0b6-198f-48fa-9363-64ab5ec2b222,16,0,0.0,1,1,1,4,0,0.0,07/27/2024 01:10 AM,3,4,0
6,a3a5f0b8-a135-11e9-9cda-0a87ae2ba916,9,3,0.0,1,1,1,2,0,1.0,07/27/2024 01:10 AM,4,2,1
13,a3a434ce-a135-11e9-9cda-0a87ae2ba916,3,3,0.0,1,1,1,2,0,0.0,07/27/2024 01:10 AM,11,2,0
4,a3b46866-a135-11e9-9cda-0a87ae2ba916,7,0,0.0,1,1,1,1,0,0.0,07/27/2024 01:10 AM,3,1,0
8,a3ac83bc-a135-11e9-9cda-0a87ae2ba916,6,1,0.0,1,1,1,1,0,0.0,07/27/2024 01:10 AM,7,1,0
0,a3a4ea00-a135-11e9-9cda-0a87ae2ba916,38,0,,1,1,1,0,0,,07/27/2024 01:10 AM,0,0,0
0,a3a4c618-a135-11e9-9cda-0a87ae2ba916,18,0,0.0,1,1,1,0,0,1.0,07/27/2024 01:10 AM,0,0,1
2,a3b29a90-a135-11e9-9cda-0a87ae2ba916,7,2,0.0,1,1,1,0,0,0.0,07/27/2024 01:10 AM,2,0,0
5,a3b10f66-a135-11e9-9cda-0a87ae2ba916,4,0,0.0,1,1,1,3,0,2.0,07/27/2024 01:10 AM,2,3,0
8,a3a5b496-a135-11e9-9cda-0a87ae2ba916,6,1,0.0,1,1,1,3,0,1.0,07/27/2024 01:10 AM,5,3,0
1,a3a3f5e9-a135-11e9-9cda-0a87ae2ba916,11,0,0.0,1,1,1,0,0,3.0,07/27/2024 01:10 AM,1,0,3
8,a3ad8587-a135-11e9-9cda-0a87ae2ba916,18,0,0.0,1,1,1,0,0,0.0,07/27/2024 01:10 AM,8,0,0
8,a3a4d069-a135-11e9-9cda-0a87ae2ba916,22,1,0.0,1,1,1,0,0,0.0,07/27/2024 01:10 AM,8,0,0
4,a3ad2843-a135-11e9-9cda-0a87ae2ba916,14,0,0.0,1,1,1,0,0,1.0,07/27/2024 01:10 AM,4,0,1
2,a3b02ef1-a135-11e9-9cda-0a87ae2ba916,10,0,0.0,1,1,1,0,0,3.0,07/27/2024 01:10 AM,2,0,0
8,a3ab812d-a135-11e9-9cda-0a87ae2ba916,29,2,0.0,1,1,1,8,0,0.0,07/27/2024 01:10 AM,0,8,0
5,a3a9a778-a135-11e9-9cda-0a87ae2ba916,7,0,0.0,1,1,1,0,0,3.0,07/27/2024 01:10 AM,5,0,3
2,a3b1eaa7-a135-11e9-9cda-0a87ae2ba916,5,0,0.0,1,1,1,1,0,0.0,07/27/2024 01:10 AM,1,1,0
2,a3a42a93-a135-11e9-9cda-0a87ae2ba916,20,0,0.0,1,1,1,0,0,1.0,07/27/2024 01:10 AM,2,0,1
4,a3b26084-a135-11e9-9cda-0a87ae2ba916,6,1,0.0,1,1,1,0,0,0.0,07/27/2024 01:10 AM,4,0,0
6,a3b49122-a135-11e9-9cda-0a87ae2ba916,6,3,0.0,1,1,1,0,0,0.0,07/27/2024 01:10 AM,6,0,0
8,a3b2810e-a135-11e9-9cda-0a87ae2ba916,0,3,0.0,1,1,1,0,0,0.0,07/27/2024 01:10 AM,8,0,0
2,a3b2b92c-a135-11e9-9cda-0a87ae2ba916,8,1,0.0,1,1,1,1,0,0.0,07/27/2024 01:10 AM,1,1,0
4,a3aa5ed1-a135-11e9-9cda-0a87ae2ba916,6,0,0.0,1,1,1,2,0,1.0,07/27/2024 01:10 AM,2,2,0
0,61695579-2f75-4090-a071-c76079b5fb5d,3,4,0.0,1,1,1,0,0,0.0,07/27/2024 01:10 AM,0,0,0
2,1945195755748241796,11,2,0.0,1,1,1,0,0,0.0,07/27/2024 01:10 AM,2,0,0
7,1962566135789175644,8,0,0.0,1,1,1,0,0,0.0,07/27/2024 01:10 AM,7,0,0
2,a3aa4f80-a135-11e9-9cda-0a87ae2ba916,9,0,0.0,1,1,1,0,0,3.0,07/27/2024 01:10 AM,2,0,0
2,a3b20e8a-a135-11e9-9cda-0a87ae2ba916,6,3,0.0,1,1,1,1,0,0.0,07/27/2024 01:10 AM,1,1,0
16,a3a4f46b-a135-11e9-9cda-0a87ae2ba916,1,2,2.0,1,1,1,3,0,1.0,07/27/2024 01:10 AM,13,3,1
1,1934290131858180982,10,3,0.0,1,1,1,0,0,1.0,07/27/2024 01:10 AM,1,0,0
9,a3a88a6d-a135-11e9-9cda-0a87ae2ba916,2,0,0.0,1,1,1,6,0,0.0,07/27/2024 01:10 AM,3,6,0
7,a3aa59bb-a135-11e9-9cda-0a87ae2ba916,4,0,0.0,1,1,1,0,0,0.0,07/27/2024 01:10 AM,7,0,0
9,a3a64639-a135-11e9-9cda-0a87ae2ba916,0,2,0.0,1,1,1,6,0,3.0,07/27/2024 01:10 AM,3,6,0
0,1927677528601722888,14,0,0.0,1,1,1,0,0,1.0,07/27/2024 01:10 AM,0,0,0
1,a3b310ac-a135-11e9-9cda-0a87ae2ba916,10,3,0.0,1,1,1,1,0,0.0,07/27/2024 01:10 AM,0,1,0
4,a3b377cb-a135-11e9-9cda-0a87ae2ba916,1,10,0.0,1,1,1,1,0,0.0,07/27/2024 01:10 AM,3,1,0
4,1869052846885132442,7,4,0.0,1,1,1,0,0,0.0,07/27/2024 01:10 AM,4,0,0
4,1859717449875884116,9,2,0.0,1,1,1,0,0,0.0,07/27/2024 01:10 AM,4,0,0
18,a3a49288-a135-11e9-9cda-0a87ae2ba916,3,1,0.0,1,1,1,2,0,1.0,07/27/2024 01:10 AM,16,2,1
8,a3a3bc53-a135-11e9-9cda-0a87ae2ba916,4,3,0.0,1,1,1,0,0,0.0,07/27/2024 01:10 AM,8,0,0
6,a3b42a3e-a135-11e9-9cda-0a87ae2ba916,3,0,0.0,1,1,1,6,0,2.0,07/27/2024 01:10 AM,0,6,0
13,a3afb917-a135-11e9-9cda-0a87ae2ba916,1,1,0.0,1,1,1,9,0,0.0,07/27/2024 01:10 AM,4,9,0
11,a3a8224f-a135-11e9-9cda-0a87ae2ba916,9,1,0.0,1,1,1,1,0,1.0,07/27/2024 01:10 AM,10,1,0
0,a3aa10ca-a135-11e9-9cda-0a87ae2ba916,13,6,0.0,1,1,1,0,0,0.0,07/27/2024 01:10 AM,0,0,0
8,1955904736576827886,4,3,0.0,1,1,1,0,0,0.0,07/27/2024 01:08 AM,8,0,0
9,a3b41f78-a135-11e9-9cda-0a87ae2ba916,21,0,0.0,1,1,1,5,0,1.0,07/27/2024 01:09 AM,4,5,1
5,bbf9b599-1873-4133-b670-a0ef9e5c429c,10,0,0.0,1,1,1,1,0,0.0,07/27/2024 01:09 AM,4,1,0
9,a3ad6c01-a135-11e9-9cda-0a87ae2ba916,5,1,0.0,1,1,1,2,0,0.0,07/27/2024 01:09 AM,7,2,0
4,1961473975097987236,11,0,0.0,1,1,1,0,0,0.0,07/27/2024 01:08 AM,4,0,0
10,a3acbc0b-a135-11e9-9cda-0a87ae2ba916,7,0,0.0,1,1,1,5,0,2.0,07/27/2024 01:09 AM,5,5,0
3,a3b372b1-a135-11e9-9cda-0a87ae2ba916,11,1,0.0,1,1,1,0,0,0.0,07/27/2024 01:09 AM,3,0,0
8,a3af1cec-a135-11e9-9cda-0a87ae2ba916,1,2,0.0,1,1,1,3,0,0.0,07/27/2024 01:09 AM,5,3,0
3,1932130426977611818,11,1,0.0,1,1,1,2,0,0.0,07/27/2024 01:09 AM,1,2,0
2,1931391724317609988,7,0,0.0,1,1,1,2,0,6.0,07/27/2024 01:09 AM,0,2,0
5,1945087711550943880,3,0,0.0,1,1,1,4,0,7.0,07/27/2024 01:09 AM,1,4,0
3,a3b37ce0-a135-11e9-9cda-0a87ae2ba916,15,1,0.0,1,1,1,0,0,1.0,07/27/2024 01:09 AM,3,0,0
3,a3b1cf80-a135-11e9-9cda-0a87ae2ba916,8,0,0.0,1,1,1,0,0,0.0,07/27/2024 01:09 AM,3,0,0
7,1932441844638063332,8,0,0.0,1,1,1,3,0,0.0,07/27/2024 01:09 AM,4,3,0
2,a3ad711d-a135-11e9-9cda-0a87ae2ba916,15,3,0.0,1,1,1,0,0,0.0,07/27/2024 01:09 AM,1,0,0
11,a3af1767-a135-11e9-9cda-0a87ae2ba916,7,3,0.0,1,1,1,3,0,1.0,07/27/2024 01:09 AM,8,3,0
15,a3a4cb42-a135-11e9-9cda-0a87ae2ba916,3,1,0.0,1,1,1,9,0,4.0,07/27/2024 01:09 AM,6,9,4
4,a3aa9c65-a135-11e9-9cda-0a87ae2ba916,12,0,2.0,1,1,1,1,0,1.0,07/27/2024 01:09 AM,3,1,1
3,a3adce47-a135-11e9-9cda-0a87ae2ba916,11,0,0.0,1,1,1,2,0,1.0,07/27/2024 01:09 AM,1,2,0
4,a3a4d588-a135-11e9-9cda-0a87ae2ba916,26,7,2.0,1,1,1,3,0,1.0,07/27/2024 01:09 AM,1,3,0
1,a3b424f6-a135-11e9-9cda-0a87ae2ba916,9,5,0.0,1,1,1,1,0,0.0,07/27/2024 01:09 AM,0,1,0
11,a3a6d371-a135-11e9-9cda-0a87ae2ba916,0,1,0.0,1,1,1,3,0,3.0,07/27/2024 01:09 AM,8,3,0
5,1936560950769470316,4,0,0.0,1,1,1,5,0,5.0,07/27/2024 01:09 AM,0,5,0
6,a3a3983e-a135-11e9-9cda-0a87ae2ba916,0,5,0.0,1,1,1,2,0,0.0,07/27/2024 01:09 AM,4,2,0
3,0eeb6baf-c653-4a1a-af17-99f686116b89,9,3,0.0,1,1,1,0,0,0.0,07/27/2024 01:09 AM,3,0,0
5,ce334dea-c5ba-45ca-a52d-39dc161683b0,10,0,0.0,1,1,1,5,0,0.0,07/27/2024 01:09 AM,0,5,0
15,a3aa9732-a135-11e9-9cda-0a87ae2ba916,4,0,0.0,1,1,1,2,0,0.0,07/27/2024 01:09 AM,13,2,0
12,a3a5ce97-a135-11e9-9cda-0a87ae2ba916,3,3,0.0,1,1,1,9,0,1.0,07/27/2024 01:09 AM,3,9,1
2,a3afe6ed-a135-11e9-9cda-0a87ae2ba916,12,0,0.0,1,1,1,1,0,1.0,07/27/2024 01:09 AM,1,1,0
7,a3a59915-a135-11e9-9cda-0a87ae2ba916,2,8,0.0,1,1,1,2,0,2.0,07/27/2024 01:09 AM,5,2,2
10,a3acef62-a135-11e9-9cda-0a87ae2ba916,3,1,0.0,1,1,1,0,0,1.0,07/27/2024 01:09 AM,10,0,1
0,1968516035938026380,15,0,,1,1,1,0,0,,07/27/2024 01:09 AM,0,0,0
0,1929934715947649384,15,0,,1,1,1,0,0,,07/27/2024 01:09 AM,0,0,0
9,a3a405a1-a135-11e9-9cda-0a87ae2ba916,8,0,0.0,1,1,1,0,0,2.0,07/27/2024 01:09 AM,9,0,2
1,a3b24c1f-a135-11e9-9cda-0a87ae2ba916,9,1,0.0,1,1,1,0,0,0.0,07/27/2024 01:09 AM,1,0,0
6,a3b43eb7-a135-11e9-9cda-0a87ae2ba916,4,1,0.0,1,1,1,0,0,0.0,07/27/2024 01:09 AM,6,0,0
5,a3af8642-a135-11e9-9cda-0a87ae2ba916,9,0,0.0,1,1,1,3,0,1.0,07/27/2024 01:09 AM,2,3,0
8,a3b4afb6-a135-11e9-9cda-0a87ae2ba916,5,1,0.0,1,1,1,0,0,1.0,07/27/2024 01:09 AM,8,0,0
5,a3a50ec8-a135-11e9-9cda-0a87ae2ba916,30,7,0.0,1,1,1,3,0,5.0,07/27/2024 01:09 AM,2,3,5
10,1861997616150114834,5,0,0.0,1,1,1,9,0,0.0,07/27/2024 01:09 AM,1,9,0
5,a3a38363-a135-11e9-9cda-0a87ae2ba916,30,0,1.0,1,1,1,0,0,0.0,07/27/2024 01:09 AM,5,0,0
2,1861589903150238332,9,4,0.0,1,1,1,0,0,0.0,07/27/2024 01:09 AM,2,0,0
10,a3a503e5-a135-11e9-9cda-0a87ae2ba916,6,1,0.0,1,1,1,0,0,0.0,07/27/2024 01:09 AM,10,0,0
4,a3a40ad8-a135-11e9-9cda-0a87ae2ba916,18,2,0.0,1,1,1,1,0,3.0,07/27/2024 01:09 AM,3,1,3
4,a3af6c2f-a135-11e9-9cda-0a87ae2ba916,10,0,0.0,1,1,1,2,0,1.0,07/27/2024 01:09 AM,2,2,0
4,a3a482fb-a135-11e9-9cda-0a87ae2ba916,17,6,0.0,1,1,1,0,0,0.0,07/27/2024 01:09 AM,4,0,0
2,1934288914372987240,13,0,0.0,1,1,1,0,0,0.0,07/27/2024 01:09 AM,2,0,0
15,a3a55b3e-a135-11e9-9cda-0a87ae2ba916,7,5,0.0,1,1,1,0,0,0.0,07/27/2024 01:09 AM,15,0,0
14,a3a4591a-a135-11e9-9cda-0a87ae2ba916,24,4,0.0,1,1,1,2,0,1.0,07/27/2024 01:09 AM,12,2,1
5,a3a37e26-a135-11e9-9cda-0a87ae2ba916,15,3,0.0,1,1,1,0,0,0.0,07/27/2024 01:09 AM,5,0,0
9,a3ad523f-a135-11e9-9cda-0a87ae2ba916,5,1,0.0,1,1,1,0,0,0.0,07/27/2024 01:09 AM,9,0,0
29,9e1fbaaa-e872-4505-ada6-5080e62bef77,0,0,0.0,1,1,1,1,0,2.0,07/27/2024 01:09 AM,28,1,0
9,87c01e57-8a00-430d-9eb3-2abe51e535dd,6,0,0.0,1,1,1,2,0,0.0,07/27/2024 01:10 AM,7,2,0
10,a3aad940-a135-11e9-9cda-0a87ae2ba916,5,0,0.0,1,1,1,1,0,0.0,07/27/2024 01:10 AM,9,1,0
1,a3a7c341-a135-11e9-9cda-0a87ae2ba916,14,0,0.0,1,1,1,0,0,0.0,07/27/2024 01:09 AM,1,0,0
11,1942118282074374350,3,1,0.0,1,1,1,7,0,0.0,07/27/2024 01:09 AM,4,7,0
2,1942112671760511044,13,0,0.0,1,1,1,0,0,0.0,07/27/2024 01:10 AM,2,0,0
6,1945195574597886460,6,3,0.0,1,1,1,0,0,0.0,07/27/2024 01:10 AM,6,0,0
0,a3a786ac-a135-11e9-9cda-0a87ae2ba916,18,1,0.0,1,1,1,0,0,0.0,07/27/2024 01:10 AM,0,0,0
13,a3a7e19b-a135-11e9-9cda-0a87ae2ba916,15,1,0.0,1,1,1,0,0,2.0,07/27/2024 01:10 AM,13,0,2
8,a3a9ecff-a135-11e9-9cda-0a87ae2ba916,1,4,1.0,1,1,1,0,0,1.0,07/27/2024 01:10 AM,8,0,1
6,a3b42f5f-a135-11e9-9cda-0a87ae2ba916,3,0,0.0,1,1,1,3,0,2.0,07/27/2024 01:10 AM,3,3,0
6,a3afc858-a135-11e9-9cda-0a87ae2ba916,3,2,0.0,1,1,1,0,0,0.0,07/27/2024 01:10 AM,6,0,0
8,a3b2dcf0-a135-11e9-9cda-0a87ae2ba916,2,1,0.0,1,1,1,0,0,0.0,07/27/2024 01:10 AM,8,0,0
6,7dc58bb9-24de-4544-9a12-c3975139370f,8,1,0.0,1,1,1,1,0,0.0,07/27/2024 01:10 AM,5,1,0
7,a3a974e1-a135-11e9-9cda-0a87ae2ba916,9,1,1.0,1,1,1,7,0,1.0,07/27/2024 01:10 AM,0,7,1
2,1951050538021341810,6,3,0.0,1,1,1,2,0,0.0,07/27/2024 01:10 AM,0,2,0
5,a3ade2c3-a135-11e9-9cda-0a87ae2ba916,4,1,0.0,1,1,1,0,0,1.0,07/27/2024 01:10 AM,5,0,0
13,3d1da4c7-23c9-4731-81f5-91db08f6c97f,2,0,0.0,1,1,1,8,0,0.0,07/27/2024 01:10 AM,5,8,0
3,a3b1db23-a135-11e9-9cda-0a87ae2ba916,6,1,0.0,1,1,1,0,0,1.0,07/27/2024 01:10 AM,3,0,0
5,1962563227519515280,8,2,0.0,1,1,1,4,0,0.0,07/27/2024 01:10 AM,1,4,0
4,a3afa4c3-a135-11e9-9cda-0a87ae2ba916,8,3,0.0,1,1,1,1,0,0.0,07/27/2024 01:10 AM,3,1,0
7,a3aa0699-a135-11e9-9cda-0a87ae2ba916,11,6,0.0,1,1,1,1,0,0.0,07/27/2024 01:10 AM,6,1,0
0,a3a7258b-a135-11e9-9cda-0a87ae2ba916,13,1,1.0,1,1,1,0,0,0.0,07/27/2024 01:10 AM,0,0,0
3,a3a7be40-a135-11e9-9cda-0a87ae2ba916,12,0,0.0,1,1,1,1,0,1.0,07/27/2024 01:10 AM,2,1,0
3,a3ad9ad9-a135-11e9-9cda-0a87ae2ba916,8,0,0.0,1,1,1,0,0,0.0,07/27/2024 01:10 AM,3,0,0
5,a3af4b26-a135-11e9-9cda-0a87ae2ba916,7,3,0.0,1,1,1,2,0,0.0,07/27/2024 01:10 AM,3,2,0
7,1934009488956756950,8,0,0.0,1,1,1,3,0,0.0,07/27/2024 01:10 AM,4,3,0
5,a3b0f5c9-a135-11e9-9cda-0a87ae2ba916,0,2,0.0,1,1,1,2,0,0.0,07/27/2024 01:10 AM,3,2,0
3,a3b2659d-a135-11e9-9cda-0a87ae2ba916,8,0,0.0,1,1,1,0,0,0.0,07/27/2024 01:10 AM,3,0,0
19,a3aac4f9-a135-11e9-9cda-0a87ae2ba916,1,2,1.0,1,1,1,7,0,1.0,07/27/2024 01:10 AM,12,7,0
1,a3a86c05-a135-11e9-9cda-0a87ae2ba916,21,5,0.0,1,1,1,1,0,0.0,07/27/2024 01:10 AM,0,1,0
1,a3a53843-a135-11e9-9cda-0a87ae2ba916,12,2,0.0,1,1,1,0,0,0.0,07/27/2024 01:10 AM,1,0,0
7,1936560699993133354,7,1,0.0,1,1,1,2,0,0.0,07/27/2024 01:10 AM,5,2,0
3,1967731401884924158,12,0,0.0,1,1,1,0,0,0.0,07/27/2024 01:10 AM,3,0,0
6,a3a39d55-a135-11e9-9cda-0a87ae2ba916,9,0,0.0,1,1,1,3,0,0.0,07/27/2024 01:10 AM,3,3,0
18,a3a57527-a135-11e9-9cda-0a87ae2ba916,0,2,1.0,1,1,1,3,0,5.0,07/27/2024 01:10 AM,15,3,5
12,a3a589b9-a135-11e9-9cda-0a87ae2ba916,4,4,0.0,1,1,1,10,0,2.0,07/27/2024 01:10 AM,2,10,0
6,a3ac4a7c-a135-11e9-9cda-0a87ae2ba916,3,2,0.0,1,1,1,0,0,0.0,07/27/2024 01:10 AM,6,0,0
9,a3a593fc-a135-11e9-9cda-0a87ae2ba916,18,0,0.0,1,1,1,1,0,0.0,07/27/2024 01:10 AM,8,1,0
12,a3a5e353-a135-11e9-9cda-0a87ae2ba916,2,0,0.0,1,1,1,1,0,0.0,07/27/2024 01:10 AM,11,1,0
4,a3b2956a-a135-11e9-9cda-0a87ae2ba916,5,2,0.0,1,1,1,0,0,0.0,07/27/2024 01:10 AM,4,0,0
6,a3a7b936-a135-11e9-9cda-0a87ae2ba916,0,2,0.0,1,1,1,1,0,3.0,07/27/2024 01:10 AM,5,1,0
13,a3a3c174-a135-11e9-9cda-0a87ae2ba916,2,0,0.0,1,1,1,2,0,0.0,07/27/2024 01:10 AM,11,2,0
13,a3a6ce53-a135-11e9-9cda-0a87ae2ba916,1,1,0.0,1,1,1,0,0,0.0,07/27/2024 01:10 AM,13,0,0
3,a3add365-a135-11e9-9cda-0a87ae2ba916,7,1,0.0,1,1,1,0,0,0.0,07/27/2024 01:10 AM,3,0,0
17,a3a4daa1-a135-11e9-9cda-0a87ae2ba916,7,2,0.0,1,1,1,3,0,1.0,07/27/2024 01:10 AM,14,3,1
3,a3b2e72c-a135-11e9-9cda-0a87ae2ba916,8,4,0.0,1,1,1,2,0,0.0,07/27/2024 01:10 AM,1,2,0
8,a3b4a579-a135-11e9-9cda-0a87ae2ba916,7,0,0.0,1,1,1,4,0,0.0,07/27/2024 01:10 AM,4,4,0
5,6997d1fb-9887-4c15-b5db-524d45a2f101,10,0,0.0,1,1,1,1,0,0.0,07/27/2024 01:10 AM,4,1,0
9,a3a9a24f-a135-11e9-9cda-0a87ae2ba916,4,0,0.0,1,1,1,3,0,2.0,07/27/2024 01:10 AM,6,3,2
5,a3ae82e0-a135-11e9-9cda-0a87ae2ba916,5,1,0.0,1,1,1,1,0,0.0,07/27/2024 01:10 AM,4,1,0
3,1932128180709716638,8,0,0.0,1,1,1,0,0,0.0,07/27/2024 01:10 AM,3,0,0
2,a3ada52f-a135-11e9-9cda-0a87ae2ba916,8,0,0.0,1,1,1,0,0,1.0,07/27/2024 01:10 AM,2,0,0
2,a3acfa38-a135-11e9-9cda-0a87ae2ba916,8,1,0.0,1,1,1,0,0,0.0,07/27/2024 01:10 AM,2,0,0
8,1934289552037596050,5,1,0.0,1,1,1,4,0,2.0,07/27/2024 01:10 AM,4,4,0
5,1932836901177930130,4,1,0.0,1,1,1,0,0,1.0,07/27/2024 01:10 AM,5,0,0
9,a3aa7db3-a135-11e9-9cda-0a87ae2ba916,9,1,0.0,1,1,1,2,0,0.0,07/27/2024 01:10 AM,7,2,0
2,a3a6f2a2-a135-11e9-9cda-0a87ae2ba916,8,0,1.0,1,1,1,1,0,4.0,07/27/2024 01:10 AM,1,1,0
3,1867227665093179888,4,8,0.0,1,1,1,2,0,0.0,07/27/2024 01:10 AM,1,2,0
5,a3aaf7bc-a135-11e9-9cda-0a87ae2ba916,4,1,0.0,1,1,1,0,0,1.0,07/27/2024 01:10 AM,5,0,1
8,a3a9da3b-a135-11e9-9cda-0a87ae2ba916,7,1,0.0,1,1,1,1,0,3.0,07/27/2024 01:10 AM,7,1,3
6,1938033609511385892,9,0,0.0,1,1,1,0,0,0.0,07/27/2024 01:10 AM,6,0,0
6,a3af9f99-a135-11e9-9cda-0a87ae2ba916,2,3,0.0,1,1,1,4,0,0.0,07/27/2024 01:10 AM,2,4,0
4,a3acd078-a135-11e9-9cda-0a87ae2ba916,7,0,0.0,1,1,1,3,0,0.0,07/27/2024 01:10 AM,1,3,0
9,a3b128de-a135-11e9-9cda-0a87ae2ba916,2,0,0.0,1,1,1,8,0,0.0,07/27/2024 01:10 AM,1,8,0
4,1958859802548216454,11,0,0.0,1,1,1,0,0,0.0,07/27/2024 01:10 AM,4,0,0
7,a3b0dc1f-a135-11e9-9cda-0a87ae2ba916,3,1,0.0,1,1,1,1,0,0.0,07/27/2024 01:10 AM,6,1,0
8,a3a78bc0-a135-11e9-9cda-0a87ae2ba916,40,7,0.0,1,1,1,1,0,0.0,07/27/2024 01:10 AM,7,1,0
5,ad9f8858-dc27-43ca-8fdc-78044b22f1fc,9,1,0.0,1,1,1,2,0,0.0,07/27/2024 01:10 AM,3,2,0
1,a3ada002-a135-11e9-9cda-0a87ae2ba916,2,2,0.0,1,1,1,0,0,6.0,07/27/2024 01:10 AM,1,0,0
0,a3a9e44a-a135-11e9-9cda-0a87ae2ba916,29,2,0.0,1,1,1,0,0,0.0,07/27/2024 01:10 AM,0,0,0
5,a3a781a6-a135-11e9-9cda-0a87ae2ba916,6,0,0.0,1,1,1,0,0,0.0,07/27/2024 01:10 AM,5,0,0
10,a3aa2abb-a135-11e9-9cda-0a87ae2ba916,0,4,1.0,1,1,1,1,0,4.0,07/27/2024 01:10 AM,9,1,0
3,a3b4aa91-a135-11e9-9cda-0a87ae2ba916,4,0,0.0,1,1,1,0,0,0.0,07/27/2024 01:10 AM,3,0,0
6,1958860132283810038,5,0,0.0,1,1,1,1,0,0.0,07/27/2024 01:10 AM,5,1,0
4,2f5957e4-e83a-4d5a-b073-ec9422989315,11,0,0.0,1,1,1,0,0,0.0,07/27/2024 01:10 AM,4,0,0
6,a3b28b4a-a135-11e9-9cda-0a87ae2ba916,3,1,0.0,1,1,1,1,0,1.0,07/27/2024 01:10 AM,5,1,0
4,0f9b826b-8885-4c25-96fd-9e2c2074c34e,11,0,0.0,1,1,1,1,0,0.0,07/27/2024 01:10 AM,3,1,0
5,1863878044896486356,3,0,1.0,1,1,1,4,0,6.0,07/27/2024 01:10 AM,1,4,0
1,bc4d498d-c272-4474-beca-10e5268e7253,13,1,0.0,1,1,1,0,0,0.0,07/27/2024 01:10 AM,1,0,0
5,1879437308430949172,5,5,0.0,1,1,1,0,0,0.0,07/27/2024 01:10 AM,5,0,0
1,a3a37378-a135-11e9-9cda-0a87ae2ba916,43,10,1.0,1,1,1,0,0,0.0,07/27/2024 01:10 AM,1,0,0
3,a3b143aa-a135-11e9-9cda-0a87ae2ba916,6,1,0.0,1,1,1,0,0,0.0,07/27/2024 01:10 AM,3,0,0
6,98fe78dc-4efa-4b39-a47c-0d94abcdb221,2,3,0.0,1,1,1,6,0,0.0,07/27/2024 01:10 AM,0,6,0
13,1928795714838393816,1,0,0.0,1,1,1,9,0,1.0,07/27/2024 01:10 AM,4,9,0
13,a3a56075-a135-11e9-9cda-0a87ae2ba916,10,0,0.0,1,1,1,1,0,4.0,07/27/2024 01:10 AM,12,1,4
3,a3af9064-a135-11e9-9cda-0a87ae2ba916,7,1,0.0,1,1,1,0,0,0.0,07/27/2024 01:10 AM,3,0,0
27,a3a4c0df-a135-11e9-9cda-0a87ae2ba916,12,0,0.0,1,1,1,4,0,0.0,07/27/2024 01:10 AM,23,4,0
4,a3a43f48-a135-11e9-9cda-0a87ae2ba916,33,2,0.0,1,1,1,1,0,4.0,07/27/2024 01:10 AM,3,1,4
2,a3a513e9-a135-11e9-9cda-0a87ae2ba916,28,1,0.0,1,1,1,0,0,0.0,07/27/2024 01:10 AM,2,0,0
7,a3b49b4c-a135-11e9-9cda-0a87ae2ba916,7,1,0.0,1,1,1,1,0,0.0,07/27/2024 01:10 AM,6,1,0
9,a3a3d1b8-a135-11e9-9cda-0a87ae2ba916,3,0,0.0,1,1,1,1,0,2.0,07/27/2024 01:10 AM,8,1,2
2,a3b2b419-a135-11e9-9cda-0a87ae2ba916,9,0,0.0,1,1,1,0,0,0.0,07/27/2024 01:10 AM,2,0,0
3,a3a7a4fc-a135-11e9-9cda-0a87ae2ba916,8,0,0.0,1,1,1,0,0,0.0,07/27/2024 01:10 AM,3,0,0
4,1932113567217736592,7,2,0.0,1,1,1,2,0,2.0,07/27/2024 01:10 AM,2,2,0
2,6849c4e2-cffa-432b-8d83-5c0524594b4f,12,1,0.0,1,1,1,0,0,0.0,07/27/2024 01:10 AM,2,0,0
17,a3a453fa-a135-11e9-9cda-0a87ae2ba916,12,2,0.0,1,1,1,0,0,0.0,07/27/2024 01:10 AM,17,1,0
4,1927695368784189454,10,0,0.0,1,1,1,2,0,1.0,07/27/2024 01:10 AM,2,2,0
6,a3b0104c-a135-11e9-9cda-0a87ae2ba916,9,0,0.0,1,1,1,0,0,0.0,07/27/2024 01:10 AM,6,0,0
6,1861594737501366386,9,0,0.0,1,1,1,0,0,0.0,07/27/2024 01:10 AM,6,0,0
0,1970688691992443350,15,0,,1,1,1,0,0,,07/27/2024 01:10 AM,0,0,0
12,a3af76f8-a135-11e9-9cda-0a87ae2ba916,3,0,0.0,1,1,1,10,0,0.0,07/27/2024 01:10 AM,2,10,0
4,1867616044298100822,0,2,0.0,1,1,1,0,0,9.0,07/27/2024 01:10 AM,4,0,0
12,1869036027793202092,3,0,0.0,1,1,1,9,0,0.0,07/27/2024 01:10 AM,3,9,0
10,a3b0e657-a135-11e9-9cda-0a87ae2ba916,6,2,0.0,1,1,1,4,0,2.0,07/27/2024 01:10 AM,6,4,0
3,4b4b0d88-80e0-4ef9-a8d1-cdd6a16722f9,6,6,0.0,1,1,1,1,0,0.0,07/27/2024 01:10 AM,2,1,0
7,a3ac9834-a135-11e9-9cda-0a87ae2ba916,4,0,0.0,1,1,1,2,0,0.0,07/27/2024 01:10 AM,5,2,0
4,a3b486f2-a135-11e9-9cda-0a87ae2ba916,11,0,0.0,1,1,1,2,0,0.0,07/27/2024 01:10 AM,2,2,0
11,a3aa692e-a135-11e9-9cda-0a87ae2ba916,0,2,0.0,1,1,1,0,0,2.0,07/27/2024 01:10 AM,11,0,0
10,a3a94bc8-a135-11e9-9cda-0a87ae2ba916,3,2,0.0,1,1,1,4,0,0.0,07/27/2024 01:10 AM,6,4,0
5,1962566331666471698,10,0,0.0,1,1,1,2,0,0.0,07/27/2024 01:10 AM,3,2,0
2,a3a3e158-a135-11e9-9cda-0a87ae2ba916,20,1,0.0,1,1,1,2,0,0.0,07/27/2024 01:10 AM,0,2,0
2,1775509322900183222,6,2,0.0,1,1,1,0,1,0.0,07/27/2024 01:10 AM,2,0,0
5,1936566487749193740,10,0,0.0,1,1,1,1,0,0.0,07/27/2024 01:10 AM,4,1,0
5,a3b38c3f-a135-11e9-9cda-0a87ae2ba916,8,2,0.0,1,1,1,1,0,0.0,07/27/2024 01:10 AM,4,1,0
3,1945088454548058244,11,1,0.0,1,1,1,1,0,0.0,07/27/2024 01:10 AM,2,1,0
11,a3ac2b9c-a135-11e9-9cda-0a87ae2ba916,3,1,0.0,1,1,1,0,0,0.0,07/27/2024 01:10 AM,11,0,0
0,a3a8275e-a135-11e9-9cda-0a87ae2ba916,12,2,0.0,1,1,1,0,0,1.0,07/27/2024 01:10 AM,0,0,0
13,a3a4bbba-a135-11e9-9cda-0a87ae2ba916,8,1,0.0,1,1,1,0,0,1.0,07/27/2024 01:10 AM,13,0,1
4,a3a9bbf0-a135-11e9-9cda-0a87ae2ba916,9,0,0.0,1,1,1,1,0,2.0,07/27/2024 01:10 AM,3,1,1
9,a3a5eb69-a135-11e9-9cda-0a87ae2ba916,18,1,1.0,1,1,1,0,0,2.0,07/27/2024 01:10 AM,9,0,2
6,a3a85eda-a135-11e9-9cda-0a87ae2ba916,6,1,0.0,1,1,1,3,0,2.0,07/27/2024 01:10 AM,3,3,0
7,34dc92b5-7cb7-4536-856b-46644d31b48c,8,0,0.0,1,1,1,0,0,0.0,07/27/2024 01:10 AM,7,0,0
0,a3a9d529-a135-11e9-9cda-0a87ae2ba916,21,0,,1,1,1,0,0,,07/27/2024 01:10 AM,0,0,0
5,8759a858-d7eb-4382-b38f-2223c3f9e25d,7,3,0.0,1,1,1,5,0,0.0,07/27/2024 01:09 AM,0,5,0
6,97818a9b-0f86-44df-98e6-1bc16812e3d9,10,3,0.0,1,1,1,1,0,0.0,07/27/2024 01:09 AM,5,1,0
10,a3a3d6f0-a135-11e9-9cda-0a87ae2ba916,2,0,0.0,1,1,1,0,0,3.0,07/27/2024 01:09 AM,10,0,3
2,a3b024aa-a135-11e9-9cda-0a87ae2ba916,10,3,0.0,1,1,1,1,0,0.0,07/27/2024 01:09 AM,1,1,0
11,a3a4b164-a135-11e9-9cda-0a87ae2ba916,15,0,0.0,1,1,1,0,0,1.0,07/27/2024 01:09 AM,11,0,1
8,1929119555906179916,5,2,0.0,1,1,1,6,0,0.0,07/27/2024 01:09 AM,2,6,0
6,a3adb9a3-a135-11e9-9cda-0a87ae2ba916,10,2,0.0,1,1,1,2,0,1.0,07/27/2024 01:09 AM,4,2,0
5,a3ad5764-a135-11e9-9cda-0a87ae2ba916,5,1,0.0,1,1,1,4,0,0.0,07/27/2024 01:09 AM,1,4,0
18,a3a46361-a135-11e9-9cda-0a87ae2ba916,13,3,0.0,1,1,1,1,0,2.0,07/27/2024 01:09 AM,17,1,2
10,2a80f8d9-85dc-4c36-ba07-86d775ffd1ee,4,1,0.0,1,1,1,2,0,0.0,07/27/2024 01:09 AM,8,2,0
5,1ce9b7b2-6ef1-4e3b-abd4-85dedaf0ee65,7,2,0.0,1,1,1,0,0,1.0,07/27/2024 01:09 AM,5,0,1
0,1936560098166245516,8,6,0.0,1,1,1,0,0,1.0,07/27/2024 01:09 AM,0,0,0
7,a3a6c910-a135-11e9-9cda-0a87ae2ba916,7,0,1.0,1,1,1,4,0,0.0,07/27/2024 01:09 AM,3,4,0
0,a3a4b693-a135-11e9-9cda-0a87ae2ba916,16,1,0.0,1,1,1,0,0,7.0,07/27/2024 01:09 AM,0,0,6
12,a3b0060d-a135-11e9-9cda-0a87ae2ba916,1,2,0.0,1,1,1,2,0,0.0,07/27/2024 01:09 AM,10,2,0
17,a3acc133-a135-11e9-9cda-0a87ae2ba916,12,0,0.0,1,1,1,1,0,1.0,07/27/2024 01:09 AM,16,1,1
4,1879438378503419960,6,1,0.0,1,1,1,3,0,0.0,07/27/2024 01:09 AM,1,3,0
5,a3b2044b-a135-11e9-9cda-0a87ae2ba916,6,0,0.0,1,1,1,1,0,0.0,07/27/2024 01:09 AM,4,1,0
18,a3a7eba7-a135-11e9-9cda-0a87ae2ba916,3,0,0.0,1,1,1,2,0,2.0,07/27/2024 01:09 AM,16,2,2
3,a3a743ff-a135-11e9-9cda-0a87ae2ba916,9,3,0.0,1,1,1,3,0,0.0,07/27/2024 01:09 AM,0,3,0
3,1929968520492991056,8,4,0.0,1,1,1,0,0,0.0,07/27/2024 01:09 AM,3,0,0
6,a3a84ab4-a135-11e9-9cda-0a87ae2ba916,6,3,0.0,1,1,1,0,0,0.0,07/27/2024 01:09 AM,6,0,0
2,1932441496569160306,12,0,0.0,1,1,1,2,0,1.0,07/27/2024 01:09 AM,0,2,0
3,1884621142190397936,9,3,0.0,1,1,1,3,0,0.0,07/27/2024 01:09 AM,0,3,0
1,1955505344233296752,14,0,0.0,1,1,1,1,0,0.0,07/27/2024 01:09 AM,0,1,0
4,a3a84fb8-a135-11e9-9cda-0a87ae2ba916,8,5,0.0,1,1,1,1,0,2.0,07/27/2024 01:09 AM,3,1,0
21,a3a523a6-a135-11e9-9cda-0a87ae2ba916,1,7,0.0,1,1,1,4,0,2.0,07/27/2024 01:09 AM,17,4,2
8,a3a7faf7-a135-11e9-9cda-0a87ae2ba916,7,0,0.0,1,1,1,1,0,0.0,07/27/2024 01:09 AM,7,1,0
12,a3a478c9-a135-11e9-9cda-0a87ae2ba916,7,0,0.0,1,1,1,2,0,0.0,07/27/2024 01:09 AM,10,2,0
4,a3b4497a-a135-11e9-9cda-0a87ae2ba916,7,0,0.0,1,1,1,0,0,0.0,07/27/2024 01:09 AM,4,0,0
4,1879442377117973296,4,3,0.0,1,1,1,0,0,0.0,07/27/2024 01:09 AM,4,0,0
8,a3a4fec3-a135-11e9-9cda-0a87ae2ba916,10,1,0.0,1,1,1,6,0,0.0,07/27/2024 01:09 AM,2,6,0
8,1955858510671552648,7,0,0.0,1,1,1,3,0,0.0,07/27/2024 01:09 AM,5,3,0
6,a3b35e21-a135-11e9-9cda-0a87ae2ba916,6,1,0.0,1,1,1,1,0,2.0,07/27/2024 01:09 AM,5,1,2
9,a3ac4024-a135-11e9-9cda-0a87ae2ba916,3,3,0.0,1,1,1,2,0,0.0,07/27/2024 01:09 AM,7,2,0
5,1872722290312745226,7,3,0.0,1,1,1,1,0,0.0,07/27/2024 01:09 AM,4,1,0
4,a3b01f9c-a135-11e9-9cda-0a87ae2ba916,11,0,0.0,1,1,1,1,0,0.0,07/27/2024 01:09 AM,3,1,0
11,a3a80009-a135-11e9-9cda-0a87ae2ba916,0,0,0.0,1,1,1,0,0,0.0,07/27/2024 01:09 AM,11,0,0
3,a3b1f4fb-a135-11e9-9cda-0a87ae2ba916,8,0,0.0,1,1,1,0,0,0.0,07/27/2024 01:09 AM,3,0,0
1,a3acdff9-a135-11e9-9cda-0a87ae2ba916,1,8,0.0,1,1,1,0,0,1.0,07/27/2024 01:09 AM,1,0,0
8,a3a6de38-a135-11e9-9cda-0a87ae2ba916,1,2,0.0,1,1,1,2,0,0.0,07/27/2024 01:09 AM,6,2,0
3,1863877673940343638,11,1,0.0,1,1,1,0,0,0.0,07/27/2024 01:09 AM,3,0,0
1,a3ae78ab-a135-11e9-9cda-0a87ae2ba916,9,1,0.0,1,1,1,0,0,0.0,07/27/2024 01:09 AM,1,0,0
4,d6456ded-180b-4d6e-b020-3aa80bce5c2c,11,0,0.0,1,1,1,2,0,0.0,07/27/2024 01:09 AM,2,2,0
4,a3a4499f-a135-11e9-9cda-0a87ae2ba916,9,1,0.0,1,1,1,0,0,0.0,07/27/2024 01:09 AM,4,0,0
15,a3a4ef26-a135-11e9-9cda-0a87ae2ba916,2,2,0.0,1,1,1,0,0,0.0,07/27/2024 01:09 AM,15,0,0
6,a3a5b9d3-a135-11e9-9cda-0a87ae2ba916,8,0,0.0,1,1,1,2,0,1.0,07/27/2024 01:10 AM,4,2,1
4,a3ade7de-a135-11e9-9cda-0a87ae2ba916,3,0,0.0,1,1,1,2,0,0.0,07/27/2024 01:09 AM,2,2,0
11,a3a74947-a135-11e9-9cda-0a87ae2ba916,0,0,1.0,1,1,1,4,0,3.0,07/27/2024 01:10 AM,7,4,3
5,a4f9ba74-f1cc-4b6a-90ad-78cacd45d3e1,8,2,0.0,1,1,1,0,0,0.0,07/27/2024 01:10 AM,5,0,0
3,a3b2a9e7-a135-11e9-9cda-0a87ae2ba916,6,2,0.0,1,1,1,2,0,0.0,07/27/2024 01:10 AM,1,2,0
2,4fcebf8a-b065-4cd1-a167-211a45ada30e,12,1,0.0,1,1,1,0,0,0.0,07/27/2024 01:10 AM,2,0,0
8,7c56e4d5-92ee-4129-9a3a-d2ce89eab31d,5,2,0.0,1,1,1,1,0,0.0,07/27/2024 01:10 AM,7,1,0
12,a3a89ea8-a135-11e9-9cda-0a87ae2ba916,2,0,0.0,1,1,1,1,0,5.0,07/27/2024 01:10 AM,11,1,0
2,a3a96fd5-a135-11e9-9cda-0a87ae2ba916,0,0,0.0,1,1,1,0,0,9.0,07/27/2024 01:10 AM,2,0,9
9,a3af368c-a135-11e9-9cda-0a87ae2ba916,3,2,0.0,1,1,1,4,0,1.0,07/27/2024 01:10 AM,5,4,0
1,1890604055552786620,13,1,0.0,1,1,1,1,0,0.0,07/27/2024 01:10 AM,0,1,0
8,95185a0d-da45-406a-a892-6b37b0d29fa8,6,1,0.0,1,1,1,0,0,0.0,07/27/2024 01:10 AM,8,0,0
0,a3a4e4e3-a135-11e9-9cda-0a87ae2ba916,15,0,0.0,1,1,1,0,0,4.0,07/27/2024 01:10 AM,0,0,4
5,080ab938-2c1b-4fcf-a83d-74c5ae6ff305,10,0,0.0,1,1,1,1,0,0.0,07/27/2024 01:10 AM,4,1,0
4,1936565171921396140,6,1,0.0,1,1,1,3,0,0.0,07/27/2024 01:10 AM,1,3,0
4,10327d47-3c3a-433e-9e38-80638da64232,5,6,0.0,1,1,1,0,0,0.0,07/27/2024 01:10 AM,4,0,0
8,a3aa259c-a135-11e9-9cda-0a87ae2ba916,6,1,0.0,1,1,1,2,0,0.0,07/27/2024 01:10 AM,6,2,0
7,1866476160171649058,5,0,0.0,1,1,1,3,0,0.0,07/27/2024 01:10 AM,4,3,0
1,a3aa7897-a135-11e9-9cda-0a87ae2ba916,21,1,0.0,1,1,1,0,0,0.0,07/27/2024 01:10 AM,1,0,0
16,a3a81d33-a135-11e9-9cda-0a87ae2ba916,1,2,0.0,1,1,1,0,0,0.0,07/27/2024 01:10 AM,16,0,0
7,a3a49cd7-a135-11e9-9cda-0a87ae2ba916,9,1,0.0,1,1,1,0,0,2.0,07/27/2024 01:10 AM,7,0,2
4,a3a72aad-a135-11e9-9cda-0a87ae2ba916,37,2,0.0,1,1,1,1,0,0.0,07/27/2024 01:10 AM,3,1,0
2,a3a4203a-a135-11e9-9cda-0a87ae2ba916,16,1,0.0,1,1,1,0,0,1.0,07/27/2024 01:10 AM,2,0,0
4,a3b12dfb-a135-11e9-9cda-0a87ae2ba916,7,0,0.0,1,1,1,0,0,0.0,07/27/2024 01:10 AM,4,0,0
7,a3a3888b-a135-11e9-9cda-0a87ae2ba916,7,3,1.0,1,1,1,0,0,0.0,07/27/2024 01:10 AM,7,0,0
16,a3a50991-a135-11e9-9cda-0a87ae2ba916,14,1,0.0,1,1,1,0,0,0.0,07/27/2024 01:10 AM,16,0,0
5,a3afcd70-a135-11e9-9cda-0a87ae2ba916,8,0,1.0,1,1,1,3,0,1.0,07/27/2024 01:10 AM,2,3,0
2,1936560522747919086,8,5,0.0,1,1,1,0,0,0.0,07/27/2024 01:10 AM,2,0,0
5,48b2ed2f-18aa-4a9b-b27d-db9f6d0c8c16,10,0,0.0,1,1,1,0,0,0.0,07/27/2024 01:10 AM,5,0,0
14,a3aaaba2-a135-11e9-9cda-0a87ae2ba916,0,1,0.0,1,1,1,0,0,0.0,07/27/2024 01:10 AM,14,0,0
3,a3ad2322-a135-11e9-9cda-0a87ae2ba916,11,1,0.0,1,1,1,0,0,0.0,07/27/2024 01:10 AM,3,0,0
13,a3a72fc4-a135-11e9-9cda-0a87ae2ba916,2,2,0.0,1,1,1,0,0,2.0,07/27/2024 01:10 AM,13,0,2
1,a3a9d00a-a135-11e9-9cda-0a87ae2ba916,34,0,0.0,1,1,1,0,0,0.0,07/27/2024 01:10 AM,1,0,0
1,a3ad0ecb-a135-11e9-9cda-0a87ae2ba916,9,1,0.0,1,1,1,1,0,0.0,07/27/2024 01:10 AM,0,1,0
5,1943243743326460398,9,1,0.0,1,1,1,3,0,0.0,07/27/2024 01:10 AM,2,3,0
8,56eccb5b-f4d7-43c5-b554-a6a0a7585e5e,7,0,0.0,1,1,1,0,0,0.0,07/27/2024 01:10 AM,8,0,0
3,aea853ed-c70c-4b1b-a7a8-d33869d8d58d,12,0,0.0,1,1,1,0,0,0.0,07/27/2024 01:10 AM,3,0,0
4,a3af40f1-a135-11e9-9cda-0a87ae2ba916,9,1,0.0,1,1,1,0,0,1.0,07/27/2024 01:10 AM,4,0,0
5,1970337111172100194,9,1,0.0,1,1,1,0,0,0.0,07/27/2024 01:10 AM,5,0,0
15,13820eba-039d-4231-9228-005ab0f4e451,0,1,0.0,1,1,1,0,0,0.0,07/27/2024 01:10 AM,15,0,0
1,a3ad66e6-a135-11e9-9cda-0a87ae2ba916,10,0,0.0,1,1,1,0,0,0.0,07/27/2024 01:10 AM,1,0,0
8,a3ae7dc3-a135-11e9-9cda-0a87ae2ba916,5,2,0.0,1,1,1,1,0,0.0,07/27/2024 01:10 AM,7,1,0
6,d53ae727-5265-4b8e-a6ca-2a36dc0345c4,22,1,0.0,1,1,1,2,0,3.0,07/27/2024 01:10 AM,4,2,0
14,a3ac8dfb-a135-11e9-9cda-0a87ae2ba916,0,0,0.0,1,1,1,3,0,1.0,07/27/2024 01:10 AM,11,3,1
9,1929537544978749446,1,5,0.0,1,1,1,4,0,0.0,07/27/2024 01:10 AM,5,4,0
2,a3ad3d08-a135-11e9-9cda-0a87ae2ba916,12,1,0.0,1,1,1,0,0,0.0,07/27/2024 01:10 AM,2,0,0
14,a3a73ef1-a135-11e9-9cda-0a87ae2ba916,0,0,0.0,1,1,1,1,0,1.0,07/27/2024 01:10 AM,13,1,1
2,a3b213af-a135-11e9-9cda-0a87ae2ba916,4,0,0.0,1,1,1,0,0,1.0,07/27/2024 01:10 AM,2,0,0
0,1789242536879942642,15,3,0.0,1,1,1,0,0,1.0,07/27/2024 01:10 AM,0,0,0
3,a3a640d1-a135-11e9-9cda-0a87ae2ba916,15,2,0.0,1,1,1,0,0,7.0,07/27/2024 01:10 AM,3,0,7
4,a3aa82d0-a135-11e9-9cda-0a87ae2ba916,14,1,0.0,1,1,1,0,0,3.0,07/27/2024 01:10 AM,4,0,3
9,a3af8b51-a135-11e9-9cda-0a87ae2ba916,4,2,0.0,1,1,1,3,0,0.0,07/27/2024 01:10 AM,6,3,0
1,a3aacf29-a135-11e9-9cda-0a87ae2ba916,24,2,0.0,1,1,1,0,0,0.0,07/27/2024 01:10 AM,1,0,0
3,a3ad327e-a135-11e9-9cda-0a87ae2ba916,6,1,0.0,1,1,1,0,0,1.0,07/27/2024 01:10 AM,3,0,1
11,1928767416660546464,4,0,0.0,1,1,1,9,0,0.0,07/27/2024 01:10 AM,2,9,0
4,1942494597574009470,11,0,0.0,1,1,1,4,0,0.0,07/27/2024 01:10 AM,0,4,0
12,a3aa2ff4-a135-11e9-9cda-0a87ae2ba916,5,2,0.0,1,1,1,1,0,0.0,07/27/2024 01:10 AM,11,1,0
3,b8c74f86-2873-4818-88ac-81d9ae374add,13,1,0.0,1,1,1,0,0,3.0,07/27/2024 01:10 AM,3,0,3
3,a3b27bcf-a135-11e9-9cda-0a87ae2ba916,4,4,0.0,1,1,1,0,0,0.0,07/27/2024 01:10 AM,3,0,0
4,a3b43478-a135-11e9-9cda-0a87ae2ba916,3,0,0.0,1,1,1,0,0,0.0,07/27/2024 01:10 AM,4,0,0
2,1890604506489868740,8,1,0.0,1,1,1,0,0,4.0,07/27/2024 01:10 AM,2,0,0
3,a3aa54a0-a135-11e9-9cda-0a87ae2ba916,2,4,0.0,1,1,1,0,0,2.0,07/27/2024 01:10 AM,3,0,0
10,a3a43a25-a135-11e9-9cda-0a87ae2ba916,1,0,0.0,1,1,1,0,0,0.0,07/27/2024 01:10 AM,10,0,0
11,a3ae8d13-a135-11e9-9cda-0a87ae2ba916,0,0,0.0,1,1,1,7,0,0.0,07/27/2024 01:10 AM,4,7,0
6,a3a53324-a135-11e9-9cda-0a87ae2ba916,41,5,1.0,1,1,1,0,0,2.0,07/27/2024 01:10 AM,6,0,2
10,a3aade4c-a135-11e9-9cda-0a87ae2ba916,5,2,0.0,1,1,1,5,0,1.0,07/27/2024 01:10 AM,5,5,0
1,a3aabfe3-a135-11e9-9cda-0a87ae2ba916,18,0,0.0,1,1,1,0,0,0.0,07/27/2024 01:10 AM,1,0,0
4,1879441011318372516,5,2,0.0,1,1,1,0,0,0.0,07/27/2024 01:10 AM,4,0,0
5,a3adc925-a135-11e9-9cda-0a87ae2ba916,10,0,0.0,1,1,1,1,0,0.0,07/27/2024 01:10 AM,4,1,0
9,a3aa453c-a135-11e9-9cda-0a87ae2ba916,11,2,0.0,1,1,1,3,0,1.0,07/27/2024 01:10 AM,6,3,0
0,a3a7aa0e-a135-11e9-9cda-0a87ae2ba916,5,2,0.0,1,1,1,0,0,4.0,07/27/2024 01:10 AM,0,0,4
6,532a6e43-6efc-4c87-81a8-c75dfd8e8fde,5,1,3.0,1,1,1,1,0,0.0,07/27/2024 01:10 AM,5,1,0
3,a3a47dde-a135-11e9-9cda-0a87ae2ba916,20,0,0.0,1,1,1,0,0,1.0,07/27/2024 01:10 AM,3,0,0
4,1966261229814532840,10,1,0.0,1,1,1,0,0,0.0,07/27/2024 01:10 AM,4,0,0
7,1938034793873535334,6,2,0.0,1,1,1,0,0,0.0,07/27/2024 01:10 AM,7,0,0
5,1958859390231356014,9,1,0.0,1,1,1,3,0,0.0,07/27/2024 01:10 AM,2,3,0
33,a3a734ce-a135-11e9-9cda-0a87ae2ba916,3,2,0.0,1,1,1,1,0,0.0,07/27/2024 01:10 AM,32,2,0
27,a3a9892f-a135-11e9-9cda-0a87ae2ba916,6,4,0.0,1,1,1,3,0,2.0,07/27/2024 01:10 AM,24,2,0
6,a3a9309d-a135-11e9-9cda-0a87ae2ba916,7,2,0.0,1,1,1,1,0,0.0,07/27/2024 01:10 AM,5,1,0
9,a3a87631-a135-11e9-9cda-0a87ae2ba916,2,2,1.0,1,1,1,5,0,2.0,07/27/2024 01:10 AM,4,5,0
2,1962991219412381958,7,0,0.0,1,1,1,1,0,2.0,07/27/2024 01:10 AM,1,1,0
7,a3adaa52-a135-11e9-9cda-0a87ae2ba916,4,0,0.0,1,1,1,5,0,0.0,07/27/2024 01:10 AM,2,5,0
6,a3a51934-a135-11e9-9cda-0a87ae2ba916,8,0,0.0,1,1,1,1,0,5.0,07/27/2024 01:10 AM,5,1,5
7,1861996658372408268,5,1,0.0,1,1,1,2,0,2.0,07/27/2024 01:10 AM,5,2,0
2,a3ae923d-a135-11e9-9cda-0a87ae2ba916,10,1,0.0,1,1,1,1,0,2.0,07/27/2024 01:10 AM,1,1,0
2,a3a41af5-a135-11e9-9cda-0a87ae2ba916,35,1,0.0,1,1,1,0,0,1.0,07/27/2024 01:10 AM,2,0,1
18,a3aa6e51-a135-11e9-9cda-0a87ae2ba916,0,2,0.0,1,1,1,2,0,0.0,07/27/2024 01:10 AM,16,2,0
13,a3a7537c-a135-11e9-9cda-0a87ae2ba916,9,0,0.0,1,1,1,0,0,0.0,07/27/2024 01:10 AM,13,0,0
6,a3a57f6b-a135-11e9-9cda-0a87ae2ba916,7,2,0.0,1,1,1,4,0,0.0,07/27/2024 01:10 AM,2,4,0
7,1943243414585123730,7,1,0.0,1,1,1,1,0,0.0,07/27/2024 01:10 AM,6,1,0
3,1974452106772983826,8,0,0.0,1,1,1,3,1,0.0,07/27/2024 01:10 AM,0,3,0
4,1871992684446460008,8,3,0.0,1,1,1,2,0,0.0,07/27/2024 01:10 AM,2,2,0
15,a3a53d70-a135-11e9-9cda-0a87ae2ba916,4,0,0.0,1,1,1,1,0,0.0,07/27/2024 01:10 AM,14,1,0
7,a3accb60-a135-11e9-9cda-0a87ae2ba916,2,0,0.0,1,1,1,0,0,2.0,07/27/2024 01:10 AM,7,0,0
2,a3b2c354-a135-11e9-9cda-0a87ae2ba916,9,0,0.0,1,1,1,1,0,0.0,07/27/2024 01:10 AM,1,1,0
3,a3b305e7-a135-11e9-9cda-0a87ae2ba916,11,1,0.0,1,1,1,0,0,0.0,07/27/2024 01:10 AM,3,0,0
7,a3a3dc37-a135-11e9-9cda-0a87ae2ba916,5,2,0.0,1,1,1,0,0,1.0,07/27/2024 01:10 AM,7,0,1
2,a3aa017e-a135-11e9-9cda-0a87ae2ba916,9,0,0.0,1,1,1,1,0,0.0,07/27/2024 01:10 AM,1,1,0
8,a3a817dc-a135-11e9-9cda-0a87ae2ba916,2,2,0.0,1,1,1,3,0,3.0,07/27/2024 01:10 AM,5,3,3
4,1963672958015783854,9,2,0.0,1,1,1,1,0,0.0,07/27/2024 01:10 AM,3,1,0
7,a3a7c852-a135-11e9-9cda-0a87ae2ba916,6,1,0.0,1,1,1,1,0,1.0,07/27/2024 01:10 AM,6,1,1
2,a3b25b6d-a135-11e9-9cda-0a87ae2ba916,0,5,0.0,1,1,1,1,0,0.0,07/27/2024 01:10 AM,1,1,0
8,1945195369201185184,6,0,1.0,1,1,1,6,0,0.0,07/27/2024 01:10 AM,2,6,0
8,1942481603584237586,6,1,0.0,1,1,1,4,0,0.0,07/27/2024 01:10 AM,4,4,0
3,1963650659022207484,12,0,0.0,1,1,1,0,0,0.0,07/27/2024 01:10 AM,3,0,0
13,a3aad436-a135-11e9-9cda-0a87ae2ba916,3,3,0.0,1,1,1,0,0,0.0,07/27/2024 01:10 AM,13,0,0
6,8a677aec-442b-47b8-aff7-50852e1d26c0,5,0,0.0,1,1,1,1,0,0.0,07/27/2024 01:10 AM,5,1,0
5,a3acc649-a135-11e9-9cda-0a87ae2ba916,6,0,0.0,1,1,1,0,0,0.0,07/27/2024 01:10 AM,5,0,0
1,a3afebff-a135-11e9-9cda-0a87ae2ba916,9,1,0.0,1,1,1,0,0,0.0,07/27/2024 01:09 AM,1,0,0
4,1936582699682930930,9,2,0.0,1,1,1,1,0,0.0,07/27/2024 01:09 AM,3,1,0
10,1963305045676278322,4,1,0.0,1,1,1,4,0,0.0,07/27/2024 01:09 AM,6,4,0
0,a3b4590f-a135-11e9-9cda-0a87ae2ba916,11,0,,1,1,1,0,0,,07/27/2024 01:09 AM,0,0,0
8,a3afaef3-a135-11e9-9cda-0a87ae2ba916,10,1,0.0,1,1,1,0,0,0.0,07/27/2024 01:09 AM,8,0,0
8,a3a639f5-a135-11e9-9cda-0a87ae2ba916,0,1,0.0,1,1,1,0,0,1.0,07/27/2024 01:09 AM,8,0,1
10,a3a4a202-a135-11e9-9cda-0a87ae2ba916,13,1,2.0,1,1,1,2,0,1.0,07/27/2024 01:09 AM,8,2,1
11,a3afdcbf-a135-11e9-9cda-0a87ae2ba916,1,3,0.0,1,1,1,2,0,0.0,07/27/2024 01:09 AM,9,2,0
5,a3ad37c2-a135-11e9-9cda-0a87ae2ba916,5,1,0.0,1,1,1,0,0,0.0,07/27/2024 01:09 AM,5,0,0
1,1958859960485118844,4,0,0.0,1,1,1,0,1,10.0,07/27/2024 01:09 AM,1,0,0
3,a3b1050d-a135-11e9-9cda-0a87ae2ba916,7,4,0.0,1,1,1,0,0,0.0,07/27/2024 01:09 AM,3,0,0
4,a3a762a1-a135-11e9-9cda-0a87ae2ba916,7,0,0.0,1,1,1,0,0,0.0,07/27/2024 01:09 AM,4,0,0
3,a3ad09b2-a135-11e9-9cda-0a87ae2ba916,8,0,0.0,1,1,1,0,0,0.0,07/27/2024 01:09 AM,3,0,0
3,1931403472863201974,11,1,0.0,1,1,1,1,0,0.0,07/27/2024 01:09 AM,2,1,0
8,a3a940a2-a135-11e9-9cda-0a87ae2ba916,0,5,0.0,1,1,1,4,0,1.0,07/27/2024 01:09 AM,4,4,0
0,1945194351261708978,15,0,,1,1,1,0,0,,07/27/2024 01:09 AM,0,0,0
9,a3a3fb5d-a135-11e9-9cda-0a87ae2ba916,1,1,1.0,1,1,1,4,0,4.0,07/27/2024 01:09 AM,5,4,3
1,a3a56ae5-a135-11e9-9cda-0a87ae2ba916,18,0,0.0,1,1,1,1,0,0.0,07/27/2024 01:09 AM,0,1,0
5,a3af7c0e-a135-11e9-9cda-0a87ae2ba916,10,0,0.0,1,1,1,2,0,0.0,07/27/2024 01:09 AM,3,2,0
9,a3a80f32-a135-11e9-9cda-0a87ae2ba916,7,0,0.0,1,1,1,0,0,3.0,07/27/2024 01:09 AM,9,0,0
5,1955583912707186772,9,0,1.0,1,1,1,1,0,1.0,07/27/2024 01:09 AM,4,1,0
8,a3a54cdb-a135-11e9-9cda-0a87ae2ba916,3,0,0.0,1,1,1,1,0,0.0,07/27/2024 01:09 AM,7,1,0
11,a3a701b8-a135-11e9-9cda-0a87ae2ba916,0,2,0.0,1,1,1,5,0,2.0,07/27/2024 01:09 AM,6,5,0
3,a3b1e588-a135-11e9-9cda-0a87ae2ba916,5,2,0.0,1,1,1,1,0,1.0,07/27/2024 01:09 AM,2,1,1
16,a3ac54af-a135-11e9-9cda-0a87ae2ba916,6,1,0.0,1,1,1,0,0,0.0,07/27/2024 01:09 AM,16,0,0
5,1859718111300847802,4,6,0.0,1,1,1,0,0,0.0,07/27/2024 01:09 AM,5,0,0
15,a3a555e8-a135-11e9-9cda-0a87ae2ba916,0,0,0.0,1,1,1,0,0,0.0,07/27/2024 01:09 AM,15,0,0
16,a3a4a71e-a135-11e9-9cda-0a87ae2ba916,6,1,0.0,1,1,1,13,0,0.0,07/27/2024 01:09 AM,3,13,0
4,a3a42fa7-a135-11e9-9cda-0a87ae2ba916,11,0,0.0,1,1,1,0,0,0.0,07/27/2024 01:09 AM,4,0,0
6,a3a44476-a135-11e9-9cda-0a87ae2ba916,12,4,0.0,1,1,1,0,1,0.0,07/27/2024 01:09 AM,6,0,0
3,a3b23263-a135-11e9-9cda-0a87ae2ba916,7,1,0.0,1,1,1,0,0,0.0,07/27/2024 01:09 AM,3,0,0
5,a3b0b801-a135-11e9-9cda-0a87ae2ba916,5,0,0.0,1,1,1,3,0,1.0,07/27/2024 01:09 AM,2,3,0
5,ee925757-31ce-41ad-9bb7-73b1bb363616,5,1,0.0,1,1,1,2,0,0.0,07/27/2024 01:09 AM,3,2,0
11,a3a70bbd-a135-11e9-9cda-0a87ae2ba916,5,0,0.0,1,1,1,1,0,3.0,07/27/2024 01:09 AM,10,1,3
5,1952605912741636714,0,4,0.0,1,1,1,2,0,6.0,07/27/2024 01:09 AM,3,2,0
3,1939575808945160592,9,3,0.0,1,1,1,0,0,0.0,07/27/2024 01:09 AM,3,0,0
6,4c57c316-82a8-4b9d-a16c-ae7922a2057a,9,0,0.0,1,1,1,3,0,0.0,07/27/2024 01:09 AM,3,3,0
3,a3adaf6b-a135-11e9-9cda-0a87ae2ba916,7,6,0.0,1,1,1,0,0,3.0,07/27/2024 01:09 AM,3,0,0
5,a3ae687f-a135-11e9-9cda-0a87ae2ba916,6,0,0.0,1,1,1,0,0,0.0,07/27/2024 01:09 AM,5,0,0
5,a3a40088-a135-11e9-9cda-0a87ae2ba916,15,0,0.0,1,1,1,0,0,2.0,07/27/2024 01:09 AM,5,0,2
2,1970337315463389684,13,0,0.0,1,1,1,0,0,0.0,07/27/2024 01:09 AM,2,0,0
20,a3a74e60-a135-11e9-9cda-0a87ae2ba916,6,2,1.0,1,1,1,2,0,2.0,07/27/2024 01:09 AM,18,2,2
13,bbb67562-1f82-4dfa-a532-231ddc35444e,1,1,0.0,1,1,1,5,0,0.0,07/27/2024 01:09 AM,8,5,0
1,1954768541828039308,10,4,0.0,1,1,1,1,0,0.0,07/27/2024 01:10 AM,0,1,0
6,a3ad1900-a135-11e9-9cda-0a87ae2ba916,5,0,0.0,1,1,1,1,0,3.0,07/27/2024 01:10 AM,5,1,3
2,a3aae870-a135-11e9-9cda-0a87ae2ba916,11,0,0.0,1,1,1,1,0,2.0,07/27/2024 01:09 AM,1,1,0
4,a3ace51b-a135-11e9-9cda-0a87ae2ba916,7,0,0.0,1,1,1,1,0,0.0,07/27/2024 01:09 AM,3,1,0
4,1934288056893243658,9,2,0.0,1,1,1,0,0,0.0,07/27/2024 01:09 AM,4,0,0
2,a3b2767f-a135-11e9-9cda-0a87ae2ba916,9,0,0.0,1,1,1,0,0,0.0,07/27/2024 01:09 AM,2,0,0
6,a3b0e141-a135-11e9-9cda-0a87ae2ba916,5,0,0.0,1,1,1,1,0,0.0,07/27/2024 01:09 AM,5,1,0
13,a3a3cbac-a135-11e9-9cda-0a87ae2ba916,9,0,0.0,1,1,1,6,0,1.0,07/27/2024 01:09 AM,7,6,1
5,59019cbc-47d4-4743-afb2-e71e9767df0c,10,0,0.0,1,1,1,3,0,0.0,07/27/2024 01:10 AM,2,3,0
9,a3afa9dc-a135-11e9-9cda-0a87ae2ba916,5,0,0.0,1,1,1,6,0,1.0,07/27/2024 01:10 AM,3,6,0
9,a3ac213b-a135-11e9-9cda-0a87ae2ba916,5,0,0.0,1,1,1,4,0,1.0,07/27/2024 01:10 AM,5,4,0
14,a3a6d884-a135-11e9-9cda-0a87ae2ba916,0,1,0.0,1,1,1,0,0,0.0,07/27/2024 01:10 AM,14,0,0
10,1927730149429352986,4,0,0.0,1,1,1,8,0,1.0,07/27/2024 01:10 AM,2,8,0
4,62cb5f1d-7dcb-4fe1-849f-d928288d73b9,9,2,0.0,1,1,1,0,0,0.0,07/27/2024 01:10 AM,4,0,0
3,a3ae737f-a135-11e9-9cda-0a87ae2ba916,4,7,0.0,1,1,1,2,0,1.0,07/27/2024 01:10 AM,1,2,0
6,a3a7d782-a135-11e9-9cda-0a87ae2ba916,15,2,0.0,1,1,1,0,0,4.0,07/27/2024 01:10 AM,6,0,4
2,a3aa1b5b-a135-11e9-9cda-0a87ae2ba916,13,0,0.0,1,1,1,0,0,0.0,07/27/2024 01:10 AM,2,0,0
5,1872723419889143870,10,0,0.0,1,1,1,0,0,0.0,07/27/2024 01:10 AM,5,0,0
8,a3a95142-a135-11e9-9cda-0a87ae2ba916,6,1,0.0,1,1,1,6,0,0.0,07/27/2024 01:10 AM,2,6,0
4,a3b1330c-a135-11e9-9cda-0a87ae2ba916,7,0,0.0,1,1,1,1,0,0.0,07/27/2024 01:10 AM,3,1,0
3,a3aaed81-a135-11e9-9cda-0a87ae2ba916,15,1,0.0,1,1,1,0,0,0.0,07/27/2024 01:10 AM,3,0,0
10,03a1610c-3ba0-4b85-b512-bc26791cb7ee,5,0,0.0,1,1,1,1,0,0.0,07/27/2024 01:10 AM,9,1,0
1,a3b3a0c8-a135-11e9-9cda-0a87ae2ba916,10,0,0.0,1,1,1,1,0,0.0,07/27/2024 01:10 AM,0,1,0
6,1861593053874186306,8,1,0.0,1,1,1,0,0,0.0,07/27/2024 01:10 AM,6,0,0
0,a3a3c696-a135-11e9-9cda-0a87ae2ba916,14,1,0.0,1,1,1,0,0,0.0,07/27/2024 01:10 AM,0,0,0
6,a3b1ca28-a135-11e9-9cda-0a87ae2ba916,0,1,0.0,1,1,1,4,0,3.0,07/27/2024 01:10 AM,2,4,0
3,a3b39bb0-a135-11e9-9cda-0a87ae2ba916,7,1,0.0,1,1,1,1,0,0.0,07/27/2024 01:10 AM,2,1,0
1,a3b0b291-a135-11e9-9cda-0a87ae2ba916,10,0,0.0,1,1,1,1,0,3.0,07/27/2024 01:10 AM,0,1,0
6,1838613156025764214,9,0,0.0,1,1,1,2,0,0.0,07/27/2024 01:10 AM,4,2,0
7,a3b0ccad-a135-11e9-9cda-0a87ae2ba916,4,0,0.0,1,1,1,1,0,0.0,07/27/2024 01:10 AM,6,1,0
11,a3a58495-a135-11e9-9cda-0a87ae2ba916,14,2,0.0,1,1,1,0,0,1.0,07/27/2024 01:10 AM,11,0,0
3,a3a6002c-a135-11e9-9cda-0a87ae2ba916,9,0,0.0,1,1,1,1,0,3.0,07/27/2024 01:10 AM,2,1,3
2,cefa52d6-b185-4969-89a6-20eb65f5c294,13,0,0.0,1,1,1,1,0,0.0,07/27/2024 01:10 AM,1,1,0
3,1939172360789937026,1,1,0.0,1,1,1,0,0,10.0,07/27/2024 01:10 AM,3,0,0
3,1934288340856818638,10,2,0.0,1,1,1,0,0,0.0,07/27/2024 01:10 AM,3,0,0
15,a3aa1623-a135-11e9-9cda-0a87ae2ba916,4,0,0.0,1,1,1,2,0,0.0,07/27/2024 01:10 AM,13,2,0
3,cec28069-2a36-48e1-bcec-2364b44834c4,6,6,0.0,1,1,1,0,0,0.0,07/27/2024 01:10 AM,3,0,0
11,a3a7e69e-a135-11e9-9cda-0a87ae2ba916,0,0,0.0,1,1,1,1,0,0.0,07/27/2024 01:10 AM,10,1,0
3,a3aded13-a135-11e9-9cda-0a87ae2ba916,8,0,0.0,1,1,1,2,0,0.0,07/27/2024 01:10 AM,1,2,0
2,a3b2af02-a135-11e9-9cda-0a87ae2ba916,8,1,0.0,1,1,1,0,0,0.0,07/27/2024 01:10 AM,2,0,0
9,1936552997477483122,6,0,0.0,1,1,1,9,0,0.0,07/27/2024 01:10 AM,0,9,0
2,b09832de-1c8e-4b92-bd72-bd98dc80b92c,11,2,0.0,1,1,1,0,0,0.0,07/27/2024 01:10 AM,2,0,0
5,1945194573870506886,10,0,0.0,1,1,1,2,0,1.0,07/27/2024 01:10 AM,3,2,0
3,a3a5428e-a135-11e9-9cda-0a87ae2ba916,32,0,0.0,1,1,1,0,0,0.0,07/27/2024 01:10 AM,3,0,0
14,a3a9fc75-a135-11e9-9cda-0a87ae2ba916,3,0,1.0,1,1,1,6,0,1.0,07/27/2024 01:10 AM,8,6,1
14,a3affb22-a135-11e9-9cda-0a87ae2ba916,3,2,0.0,1,1,1,1,0,0.0,07/27/2024 01:10 AM,13,1,0
22,a3a80a1e-a135-11e9-9cda-0a87ae2ba916,0,1,0.0,1,1,1,0,0,0.0,07/27/2024 01:10 AM,22,0,0
12,a3a6ed98-a135-11e9-9cda-0a87ae2ba916,2,1,0.0,1,1,1,1,0,0.0,07/27/2024 01:10 AM,11,1,0
6,a3aa2078-a135-11e9-9cda-0a87ae2ba916,4,4,1.0,1,1,1,1,0,0.0,07/27/2024 01:09 AM,5,1,0
23,a3a95669-a135-11e9-9cda-0a87ae2ba916,1,1,0.0,1,1,1,3,0,2.0,07/27/2024 01:09 AM,20,3,0
4,a3b44eba-a135-11e9-9cda-0a87ae2ba916,2,1,0.0,1,1,1,3,0,0.0,07/27/2024 01:09 AM,1,3,0
9,a3a840a6-a135-11e9-9cda-0a87ae2ba916,3,11,0.0,1,1,1,5,0,0.0,07/27/2024 01:09 AM,4,5,0
4,1932088872431302840,10,1,0.0,1,1,1,1,0,0.0,07/27/2024 01:09 AM,3,1,0
4,a3adb48a-a135-11e9-9cda-0a87ae2ba916,7,0,0.0,1,1,1,0,0,0.0,07/27/2024 01:09 AM,4,0,0
2,a3a634dd-a135-11e9-9cda-0a87ae2ba916,11,1,1.0,1,1,1,1,0,0.0,07/27/2024 01:09 AM,1,1,0
7,a3a93622-a135-11e9-9cda-0a87ae2ba916,7,1,0.0,1,1,1,2,0,0.0,07/27/2024 01:09 AM,5,2,0
6,a3b2cd97-a135-11e9-9cda-0a87ae2ba916,2,3,0.0,1,1,1,2,0,0.0,07/27/2024 01:09 AM,4,2,0
4,a3aa4a58-a135-11e9-9cda-0a87ae2ba916,15,0,0.0,1,1,1,2,0,0.0,07/27/2024 01:09 AM,2,2,0
8,a3acb6f3-a135-11e9-9cda-0a87ae2ba916,7,0,0.0,1,1,1,4,0,0.0,07/27/2024 01:09 AM,4,4,0
12,a3ac0fff-a135-11e9-9cda-0a87ae2ba916,6,1,0.0,1,1,1,0,0,0.0,07/27/2024 01:09 AM,12,0,0
2,a3ac88db-a135-11e9-9cda-0a87ae2ba916,5,2,0.0,1,1,1,0,0,2.0,07/27/2024 01:09 AM,2,0,2
28,a3a945c0-a135-11e9-9cda-0a87ae2ba916,10,0,1.0,1,1,1,0,0,0.0,07/27/2024 01:09 AM,28,0,0
5,a3b26fee-a135-11e9-9cda-0a87ae2ba916,2,4,0.0,1,1,1,1,0,0.0,07/27/2024 01:09 AM,4,1,0
10,a3a5c96f-a135-11e9-9cda-0a87ae2ba916,0,2,0.0,1,1,1,1,0,3.0,07/27/2024 01:09 AM,9,1,0
6,a3a71b0a-a135-11e9-9cda-0a87ae2ba916,3,1,0.0,1,1,1,2,0,1.0,07/27/2024 01:09 AM,4,2,1
14,a3a715ce-a135-11e9-9cda-0a87ae2ba916,1,0,0.0,1,1,1,1,0,0.0,07/27/2024 01:09 AM,13,1,0
4,a3b2ec43-a135-11e9-9cda-0a87ae2ba916,11,0,0.0,1,1,1,2,0,0.0,07/27/2024 01:09 AM,2,2,0
10,a3ae6e48-a135-11e9-9cda-0a87ae2ba916,1,0,0.0,1,1,1,8,0,0.0,07/27/2024 01:09 AM,2,8,0
5,a3a7f5ea-a135-11e9-9cda-0a87ae2ba916,9,3,0.0,1,1,1,2,0,2.0,07/27/2024 01:10 AM,3,2,0
14,a3a710c5-a135-11e9-9cda-0a87ae2ba916,1,0,0.0,1,1,1,0,0,0.0,07/27/2024 01:10 AM,14,0,0
7,a3a98429-a135-11e9-9cda-0a87ae2ba916,7,1,0.0,1,1,1,2,0,0.0,07/27/2024 01:10 AM,5,2,0
10,a3aa640c-a135-11e9-9cda-0a87ae2ba916,8,1,0.0,1,1,1,1,0,0.0,07/27/2024 01:10 AM,9,1,0
8,1866822399451882164,3,4,0.0,1,1,1,2,0,0.0,07/27/2024 01:10 AM,6,2,0
7,a3ac6f28-a135-11e9-9cda-0a87ae2ba916,12,0,0.0,1,1,1,0,0,0.0,07/27/2024 01:10 AM,7,0,0
0,1962566552401003212,14,1,0.0,1,1,1,0,0,0.0,07/27/2024 01:10 AM,0,0,0
12,a3af3bac-a135-11e9-9cda-0a87ae2ba916,0,2,0.0,1,1,1,4,0,1.0,07/27/2024 01:10 AM,8,4,0
7,1942539875938640858,6,2,0.0,1,1,1,7,0,0.0,07/27/2024 01:10 AM,0,7,0
2,a3b36d8a-a135-11e9-9cda-0a87ae2ba916,40,1,0.0,1,1,1,1,0,0.0,07/27/2024 01:10 AM,1,1,0
12,a3aaf2ac-a135-11e9-9cda-0a87ae2ba916,0,2,0.0,1,1,1,6,0,1.0,07/27/2024 01:10 AM,6,6,1
6,1887668523852444498,0,0,0.0,1,1,1,3,0,5.0,07/27/2024 01:10 AM,3,3,0
6,a3a9cafa-a135-11e9-9cda-0a87ae2ba916,9,0,0.0,1,1,1,2,0,0.0,07/27/2024 01:10 AM,4,2,0
1,a3b0fff9-a135-11e9-9cda-0a87ae2ba916,8,0,0.0,1,1,1,0,0,2.0,07/27/2024 01:10 AM,1,0,0
8,a3a4881d-a135-11e9-9cda-0a87ae2ba916,5,2,0.0,1,1,1,0,0,0.0,07/27/2024 01:10 AM,8,0,0
6,a3a83698-a135-11e9-9cda-0a87ae2ba916,11,1,1.0,1,1,1,3,0,0.0,07/27/2024 01:10 AM,3,3,0
8,a3b029be-a135-11e9-9cda-0a87ae2ba916,4,6,0.0,1,1,1,3,0,1.0,07/27/2024 01:10 AM,5,3,0
7,a3a83181-a135-11e9-9cda-0a87ae2ba916,7,1,0.0,1,1,1,4,0,0.0,07/27/2024 01:10 AM,3,4,0
5,1879439877447006990,2,8,0.0,1,1,1,1,0,0.0,07/27/2024 01:10 AM,4,1,0
5,a3b2fbb6-a135-11e9-9cda-0a87ae2ba916,8,2,0.0,1,1,1,3,0,0.0,07/27/2024 01:10 AM,2,3,0
10,a3a95b7a-a135-11e9-9cda-0a87ae2ba916,0,2,0.0,1,1,1,6,0,3.0,07/27/2024 01:10 AM,4,6,0
9,a3ad8fd9-a135-11e9-9cda-0a87ae2ba916,9,1,0.0,1,1,1,1,0,0.0,07/27/2024 01:10 AM,8,1,0
10,1870193411073343610,5,0,0.0,1,1,1,7,0,0.0,07/27/2024 01:10 AM,3,7,0
0,1965903932548317228,15,0,,1,1,1,0,0,,07/27/2024 01:10 AM,0,0,0
4,a3a4739d-a135-11e9-9cda-0a87ae2ba916,22,0,0.0,1,1,1,3,0,1.0,07/27/2024 01:10 AM,1,3,1
9,a3a93b6d-a135-11e9-9cda-0a87ae2ba916,5,1,0.0,1,1,1,1,0,0.0,07/27/2024 01:10 AM,8,1,0
5,a3b11ea4-a135-11e9-9cda-0a87ae2ba916,6,0,0.0,1,1,1,1,0,0.0,07/27/2024 01:10 AM,4,1,0
9,a3a767b1-a135-11e9-9cda-0a87ae2ba916,3,0,0.0,1,1,1,1,0,2.0,07/27/2024 01:10 AM,8,1,2
3,a3b2f15e-a135-11e9-9cda-0a87ae2ba916,11,1,0.0,1,1,1,0,0,0.0,07/27/2024 01:10 AM,3,0,0
15,a3a845b0-a135-11e9-9cda-0a87ae2ba916,0,7,0.0,1,1,1,2,0,1.0,07/27/2024 01:10 AM,13,2,0
3,a3adc3f6-a135-11e9-9cda-0a87ae2ba916,8,0,0.0,1,1,1,1,0,0.0,07/27/2024 01:10 AM,2,1,0
9,a3b4a05c-a135-11e9-9cda-0a87ae2ba916,6,0,0.0,1,1,1,5,0,0.0,07/27/2024 01:10 AM,4,5,0
4,1872721938125427506,11,0,0.0,1,1,1,0,0,0.0,07/27/2024 01:10 AM,4,0,0
7,1859717767703464460,7,1,0.0,1,1,1,3,0,0.0,07/27/2024 01:10 AM,4,3,0
0,a3a7775b-a135-11e9-9cda-0a87ae2ba916,27,0,,1,1,1,0,0,,07/27/2024 01:10 AM,0,0,0
7,a3a99346-a135-11e9-9cda-0a87ae2ba916,4,0,0.0,1,1,1,6,0,0.0,07/27/2024 01:10 AM,1,6,0
8,a3aab0b6-a135-11e9-9cda-0a87ae2ba916,4,7,0.0,1,1,1,7,0,0.0,07/27/2024 01:10 AM,1,7,0
2,a3a9df3a-a135-11e9-9cda-0a87ae2ba916,13,0,0.0,1,1,1,1,0,0.0,07/27/2024 01:10 AM,1,1,0
8,a3afe1dc-a135-11e9-9cda-0a87ae2ba916,3,0,0.0,1,1,1,2,0,0.0,07/27/2024 01:10 AM,6,2,0
10,a3aafccb-a135-11e9-9cda-0a87ae2ba916,1,2,0.0,1,1,1,1,0,2.0,07/27/2024 01:10 AM,9,1,0
10,a3a60a65-a135-11e9-9cda-0a87ae2ba916,4,1,0.0,1,1,1,1,0,4.0,07/27/2024 01:10 AM,9,1,4
7,1890602768178733256,7,1,0.0,1,1,1,0,0,0.0,07/27/2024 01:10 AM,7,0,0
5,1885794833713023406,5,2,0.0,1,1,1,0,0,0.0,07/27/2024 01:10 AM,5,0,0
5,1929516918167933834,6,0,0.0,1,1,1,0,0,0.0,07/27/2024 01:10 AM,5,0,0
8,a3a790cc-a135-11e9-9cda-0a87ae2ba916,23,0,0.0,1,1,1,4,0,0.0,07/27/2024 01:10 AM,4,4,0
12,1933956482619414962,3,0,0.0,1,1,1,11,0,0.0,07/27/2024 01:10 AM,1,11,0
2,a3b123c5-a135-11e9-9cda-0a87ae2ba916,8,0,0.0,1,1,1,1,0,1.0,07/27/2024 01:10 AM,1,1,0
4,a3a739e4-a135-11e9-9cda-0a87ae2ba916,16,8,1.0,1,1,1,1,0,2.0,07/27/2024 01:10 AM,3,1,0
6,a3af71a9-a135-11e9-9cda-0a87ae2ba916,4,0,0.0,1,1,1,3,0,1.0,07/27/2024 01:10 AM,3,3,0
6,a3a5bf01-a135-11e9-9cda-0a87ae2ba916,17,0,0.0,1,1,1,2,0,0.0,07/27/2024 01:10 AM,4,2,0
2,1963672098315411610,11,0,0.0,1,1,1,1,0,2.0,07/27/2024 01:10 AM,1,1,0
2,1869786699581020630,11,2,0.0,1,1,1,0,0,0.0,07/27/2024 01:10 AM,2,0,0
5,a3a9984a-a135-11e9-9cda-0a87ae2ba916,2,4,0.0,1,1,1,0,0,0.0,07/27/2024 01:10 AM,5,0,0
16,a3a9607f-a135-11e9-9cda-0a87ae2ba916,8,6,0.0,1,1,1,0,0,0.0,07/27/2024 01:10 AM,16,0,0
4,a3aaa17b-a135-11e9-9cda-0a87ae2ba916,13,2,0.0,1,1,1,1,0,0.0,07/27/2024 01:10 AM,3,1,0
2,a3ac1bc9-a135-11e9-9cda-0a87ae2ba916,10,3,0.0,1,1,1,0,0,1.0,07/27/2024 01:10 AM,2,0,0
4,a3ad47f8-a135-11e9-9cda-0a87ae2ba916,6,1,0.0,1,1,1,0,0,0.0,07/27/2024 01:10 AM,4,0,0
3,a3b2a4ca-a135-11e9-9cda-0a87ae2ba916,7,1,0.0,1,1,1,0,0,0.0,07/27/2024 01:10 AM,3,0,0
16,a3aa3adf-a135-11e9-9cda-0a87ae2ba916,0,5,0.0,1,1,1,7,0,2.0,07/27/2024 01:10 AM,9,7,0
1,a3a9f256-a135-11e9-9cda-0a87ae2ba916,13,4,0.0,1,1,1,0,0,0.0,07/27/2024 01:10 AM,1,0,0
0,a2aa2a53-3439-459b-9345-c21435e99a72,12,3,0.0,1,1,1,0,0,0.0,07/27/2024 01:10 AM,0,0,0
9,a3a51e6e-a135-11e9-9cda-0a87ae2ba916,5,0,0.0,1,1,1,2,0,1.0,07/27/2024 01:10 AM,7,2,1
3,a3b01578-a135-11e9-9cda-0a87ae2ba916,12,2,0.0,1,1,1,1,0,2.0,07/27/2024 01:10 AM,2,1,0
7,a3b4963f-a135-11e9-9cda-0a87ae2ba916,7,1,0.0,1,1,1,5,0,0.0,07/27/2024 01:10 AM,2,4,0
9,1859027847673133268,1,1,0.0,1,1,1,3,0,0.0,07/27/2024 01:10 AM,6,3,0
4,a5a5cb39-a6ee-45bc-96a0-6455ae111bad,10,1,0.0,1,1,1,0,0,0.0,07/27/2024 01:10 AM,4,0,0
7,a3a5fb0d-a135-11e9-9cda-0a87ae2ba916,6,1,0.0,1,1,1,0,0,0.0,07/27/2024 01:10 AM,7,0,0
2,a3b443ce-a135-11e9-9cda-0a87ae2ba916,4,0,1.0,1,1,1,1,0,5.0,07/27/2024 01:10 AM,1,1,0
3,a3acf4eb-a135-11e9-9cda-0a87ae2ba916,5,1,0.0,1,1,1,1,0,2.0,07/27/2024 01:10 AM,2,1,0
2,a3a87b3f-a135-11e9-9cda-0a87ae2ba916,8,4,0.0,1,1,1,2,0,1.0,07/27/2024 01:10 AM,0,2,0
6,1934289745311123692,8,1,0.0,1,1,1,0,0,0.0,07/27/2024 01:10 AM,6,0,0
7,1879439147302566804,3,1,0.0,1,1,1,5,0,0.0,07/27/2024 01:10 AM,2,5,0
15,a3a60f7e-a135-11e9-9cda-0a87ae2ba916,6,3,0.0,1,1,1,0,0,0.0,07/27/2024 01:10 AM,15,0,0
3,1957713517347478034,15,5,0.0,1,1,1,0,0,0.0,07/27/2024 01:10 AM,3,0,0
5,a3b2513d-a135-11e9-9cda-0a87ae2ba916,1,1,0.0,1,1,1,1,0,0.0,07/27/2024 01:10 AM,4,1,0
9,a3a79fdc-a135-11e9-9cda-0a87ae2ba916,20,1,0.0,1,1,1,1,0,0.0,07/27/2024 01:10 AM,8,1,0
1,a3b1e065-a135-11e9-9cda-0a87ae2ba916,8,0,0.0,1,1,1,0,0,2.0,07/27/2024 01:10 AM,1,0,2
5,a3a98e37-a135-11e9-9cda-0a87ae2ba916,5,1,0.0,1,1,1,1,0,0.0,07/27/2024 01:10 AM,4,1,0
6,a3a9b6e9-a135-11e9-9cda-0a87ae2ba916,7,2,0.0,1,1,1,3,0,0.0,07/27/2024 01:10 AM,3,2,0
0,a3a7b41d-a135-11e9-9cda-0a87ae2ba916,15,0,,1,1,1,0,0,,07/27/2024 01:10 AM,0,0,0
3,1927347094828755902,8,0,0.0,1,1,1,1,0,4.0,07/27/2024 01:10 AM,2,1,0
0,a3aff10c-a135-11e9-9cda-0a87ae2ba916,10,1,0.0,1,1,1,0,0,0.0,07/27/2024 01:10 AM,0,0,0
0,1806753657092916066,2,0,,1,1,1,0,0,,05/01/2023 03:06 PM,0,0,0
2,1674190368396028570,0,0,0.0,1,1,1,2,0,0.0,01/22/2023 09:45 PM,0,2,0
0,1674190334036290134,3,0,,1,1,1,0,0,0.0,01/22/2023 09:46 PM,0,0,0
0,1806749752967643692,2,0,,1,1,1,0,0,,05/01/2023 02:51 PM,0,0,0
0,1677249819534170180,1,0,,1,1,1,0,0,,01/22/2023 09:45 PM,0,0,0
0,1677249793764366376,1,0,,1,1,1,0,0,,01/22/2023 09:44 PM,0,0,0
3,1594046405283107528,5,0,0.0,1,1,1,3,0,0.0,01/22/2023 09:44 PM,0,3,0
0,1674190226662107536,1,0,,1,1,1,0,0,0.0,01/22/2023 09:47 PM,0,0,0
0,1677249858188875900,1,0,,1,1,1,0,0,0.0,01/22/2023 09:45 PM,0,0,0
0,1674190527309818774,0,1,,1,1,1,0,0,0.0,01/22/2023 09:47 PM,0,0,0
0,1806749718607905164,2,0,,1,1,1,0,0,,05/01/2023 02:51 PM,0,0,0
6,1695780074116615022,4,0,0.0,1,1,1,6,0,0.0,01/22/2023 09:45 PM,0,6,0
0,1715846718385914742,2,0,,1,1,1,0,0,,01/22/2023 09:45 PM,0,0,0
0,1677249875368745118,1,0,,1,1,1,0,0,,01/22/2023 09:46 PM,0,0,0
0,1683527933580884970,1,0,,1,1,1,0,0,0.0,01/22/2023 09:44 PM,0,0,0
4,1575949515273532128,4,0,0.0,1,1,1,4,0,1.0,01/22/2023 09:47 PM,0,4,0
0,1673852313397164648,2,0,,1,1,1,0,0,0.0,01/22/2023 09:44 PM,0,0,0
0,1674190664748772496,1,0,,1,1,1,0,0,,01/22/2023 09:45 PM,0,0,0
5,1806749731492807130,0,3,0.0,1,1,1,5,0,0.0,05/01/2023 02:51 PM,0,5,0
5,1582242289567815212,2,0,0.0,1,1,1,5,0,0.0,01/22/2023 09:47 PM,0,5,0
0,1806749718607905152,2,0,,1,1,1,0,0,,05/01/2023 02:51 PM,0,0,0
0,1806753652797948736,2,0,0.0,1,1,1,0,0,1.0,05/01/2023 03:06 PM,0,0,0
0,1674190342626224740,1,0,,1,1,1,0,0,,01/22/2023 09:44 PM,0,0,0
2,1806749748672676376,0,0,0.0,1,1,1,2,0,0.0,05/01/2023 02:51 PM,0,2,0
0,1806749727197839826,4,0,,1,1,1,0,0,,05/01/2023 02:51 PM,0,0,0
0,1827474409018810992,3,0,,1,1,1,0,0,,06/26/2023 11:14 AM,0,0,0
4,1582242319632586320,2,0,0.0,1,1,1,4,0,1.0,01/22/2023 09:45 PM,0,4,0
0,1674190299676551700,1,0,,1,1,1,0,0,,01/22/2023 09:45 PM,0,0,0
3,1594046370923369112,2,3,0.0,1,1,1,3,0,1.0,04/26/2023 08:05 PM,0,3,0
0,1715846705501012842,1,0,,1,1,1,0,0,0.0,01/22/2023 09:46 PM,0,0,0
1,1674190398460799668,0,0,0.0,1,1,1,1,0,0.0,01/22/2023 09:45 PM,0,1,0
0,1674190501540014956,2,1,,1,1,1,0,0,,01/22/2023 09:44 PM,0,0,0
0,1674190660453805190,2,0,,1,1,1,0,0,,01/22/2023 09:46 PM,0,0,0
0,1806753652797948744,2,0,,1,1,1,0,0,,05/01/2023 03:06 PM,0,0,0
0,1677249879663712418,1,0,,1,1,1,0,0,,01/22/2023 09:45 PM,0,0,0
0,1594046465420805300,8,1,0.0,1,1,1,0,0,0.0,01/22/2023 09:47 PM,0,0,0
0,1674190527309818776,1,0,,1,1,1,0,0,,01/22/2023 09:47 PM,0,0,0
0,1674190419935636184,1,0,,1,1,1,0,0,,01/22/2023 09:45 PM,0,0,0
0,1674190441410472714,1,0,,1,1,1,0,0,0.0,01/22/2023 09:45 PM,0,0,0
1,1695776990330095648,2,0,0.0,1,1,1,1,0,0.0,01/22/2023 09:45 PM,0,1,0
0,1806753644208014082,2,0,,1,1,1,0,0,,05/01/2023 03:06 PM,0,0,0
0,1674190647568903270,1,0,,1,1,1,0,0,,01/22/2023 09:44 PM,0,0,0
0,1563698679731458032,7,1,0.0,1,1,1,0,0,1.0,01/22/2023 09:46 PM,0,0,0
0,1674190278201715172,1,0,0.0,1,1,1,0,0,1.0,01/22/2023 09:46 PM,0,0,0
0,1674190273906747872,1,0,,1,1,1,0,0,,01/22/2023 09:45 PM,0,0,0
0,1674190600324262928,4,0,,1,1,1,0,0,0.0,01/22/2023 09:44 PM,0,0,0
0,1683527974474827792,1,0,0.0,1,1,1,0,0,2.0,01/22/2023 09:45 PM,0,0,0
0,1674190419935636190,1,0,0.0,1,1,1,0,0,1.0,01/22/2023 09:46 PM,0,0,0
0,1806749757262611026,4,0,,1,1,1,0,0,,05/01/2023 02:51 PM,0,0,0
0,1674190660453805188,2,0,,1,1,1,0,0,,01/22/2023 09:44 PM,0,0,0
0,1674190153647663368,1,0,,1,1,1,0,0,,01/22/2023 09:47 PM,0,0,0
0,1674190428525570800,1,0,,1,1,1,0,0,0.0,01/22/2023 09:45 PM,0,0,0
0,1674190402755766966,1,0,,1,1,1,0,0,0.0,01/22/2023 09:44 PM,0,0,0
0,1674190338331257442,1,0,,1,1,1,0,0,,01/22/2023 09:46 PM,0,0,0
0,1674190145057728760,0,1,,1,1,1,0,0,,01/22/2023 09:46 PM,0,0,0
0,1674190157942630676,2,0,,1,1,1,0,0,0.0,01/22/2023 09:45 PM,0,0,0
0,1674190359806093956,1,0,,1,1,1,0,0,0.0,01/22/2023 09:45 PM,0,0,0
0,1674190411345701580,2,0,,1,1,1,0,0,,01/22/2023 09:45 PM,0,0,0
0,1695776950890011384,2,0,,1,1,1,0,0,0.0,01/22/2023 09:44 PM,0,0,0
1,1674190269611780566,0,0,0.0,1,1,1,1,0,0.0,01/22/2023 09:46 PM,0,1,0
0,1674190574554459120,1,0,,1,1,1,0,0,0.0,01/22/2023 09:47 PM,0,0,0
0,1677249845303973994,2,0,,1,1,1,0,0,,01/22/2023 09:46 PM,0,0,0
0,1436495100903691938,0,0,,0,1,0,0,0,0.0,06/29/2024 10:47 PM,0,0,0
0,1806753657092916058,1,1,0.0,1,1,1,0,0,0.0,05/01/2023 03:06 PM,0,0,0
0,1806749722902872496,3,0,,1,1,1,0,0,,05/01/2023 02:51 PM,0,0,0
1,1715846691563848032,0,0,1.0,1,1,1,1,0,0.0,01/22/2023 09:44 PM,0,1,0
0,1674190651863870574,2,0,,1,1,1,0,0,,01/22/2023 09:44 PM,0,0,0
0,1683527950760754174,1,0,,1,1,1,0,0,,01/22/2023 09:44 PM,0,0,0
4,1594046456822715150,4,1,0.0,1,1,1,4,0,0.0,01/22/2023 09:46 PM,0,4,0
3,1674190209482238322,0,0,0.0,1,1,1,3,0,0.0,01/22/2023 09:47 PM,0,3,0
1,1715823786785102364,0,0,0.0,1,1,1,1,0,0.0,01/22/2023 09:46 PM,0,1,0
0,1674190140762761456,1,0,,1,1,1,0,0,0.0,01/22/2023 09:44 PM,0,0,0
0,1674190411345701574,1,0,,1,1,1,0,0,0.0,01/22/2023 09:47 PM,0,0,0
0,1806749722902872490,3,0,,1,1,1,0,0,,05/09/2023 11:43 AM,0,0,0
0,1674190424230603490,2,0,,1,1,1,0,0,0.0,01/22/2023 09:46 PM,0,0,0
0,1806749722902872480,2,0,,1,1,1,0,0,,05/01/2023 02:51 PM,0,0,0
0,1674190591734328324,2,0,,1,1,1,0,0,,01/22/2023 09:46 PM,0,0,0
0,1715846701206045544,2,0,,1,1,1,0,0,0.0,01/22/2023 09:46 PM,0,0,0
0,1806753665682850706,2,0,,1,1,1,0,0,,05/01/2023 03:06 PM,0,0,0
3,1561012891600925250,4,0,0.0,1,1,1,3,0,0.0,01/22/2023 09:46 PM,0,3,0
2,1674190488655113044,0,0,0.0,1,1,1,2,0,0.0,01/22/2023 09:47 PM,0,2,0
0,1677249793764366370,1,0,,1,1,1,0,0,0.0,01/22/2023 09:44 PM,0,0,0
1,1674190488655113048,0,0,0.0,1,1,1,1,0,0.0,05/08/2023 09:39 AM,0,1,0
11,1594046409578074830,0,0,0.0,1,1,1,11,0,4.0,01/22/2023 09:44 PM,0,11,0
0,1674190299676551698,1,0,,1,1,1,0,0,,01/22/2023 09:46 PM,0,0,0
0,1571105068000485406,7,2,,1,1,1,0,0,,01/22/2023 09:45 PM,0,0,0
0,1806749761557578336,2,0,,1,1,1,0,0,,05/01/2023 02:51 PM,0,0,0
0,1674190269611780562,1,0,,1,1,1,0,0,,01/22/2023 09:45 PM,0,0,0
4,1563698718386161684,4,0,0.0,1,1,1,4,0,0.0,01/22/2023 09:46 PM,0,4,0
0,1674190162237597976,1,0,,1,1,1,0,0,0.0,01/22/2023 09:46 PM,0,0,0
0,1677249823829137482,1,0,,1,1,1,0,0,,01/22/2023 09:47 PM,0,0,0
1,1806753648502981408,0,0,0.0,1,1,1,1,0,0.0,05/01/2023 03:06 PM,0,1,0
0,1674190613209164836,3,0,,1,1,1,0,0,0.0,01/22/2023 09:47 PM,0,0,0
6,1561012887305957948,2,1,0.0,1,1,1,6,0,0.0,01/22/2023 09:45 PM,0,6,0
0,1674190437115505410,2,0,,1,1,1,0,0,0.0,01/22/2023 09:44 PM,0,0,0
0,1674190355511126658,1,0,,1,1,1,0,0,,01/22/2023 09:46 PM,0,0,0
0,1674190145057728764,1,0,,1,1,1,0,0,,01/22/2023 09:45 PM,0,0,0
0,1806753631323112140,2,0,,1,1,1,0,0,0.0,05/01/2023 03:06 PM,0,0,0
0,1674190235252042152,1,0,,1,1,1,0,0,0.0,01/22/2023 09:45 PM,0,0,0
1,1571105042230683640,6,0,0.0,1,1,1,1,0,0.0,01/22/2023 09:45 PM,0,1,0
0,1674190372690995872,2,0,,1,1,1,0,0,0.0,01/22/2023 09:44 PM,0,0,0
0,1674190664748772498,2,0,,1,1,1,0,0,,01/22/2023 09:47 PM,0,0,0
0,1806753639913046782,2,0,,1,1,1,0,0,,05/01/2023 03:06 PM,0,0,0
0,1695777015314520896,1,0,,1,1,1,0,0,0.0,01/22/2023 09:44 PM,0,0,0
0,1806749725872941466,2,0,,1,1,1,0,0,,05/12/2023 09:34 AM,0,0,0
0,1521690221159885714,0,0,,0,1,0,0,0,0.0,06/29/2024 10:48 PM,0,0,0
0,1594046400988140228,9,0,0.0,1,1,1,0,0,1.0,01/22/2023 09:46 PM,0,0,0
1,1674190200892303712,0,0,0.0,1,1,1,1,0,0.0,01/22/2023 09:44 PM,0,1,0
1,1674190596029295630,1,0,0.0,1,1,1,1,0,0.0,01/22/2023 09:45 PM,0,1,0
0,1674190282496682476,2,0,,1,1,1,0,0,0.0,01/22/2023 09:44 PM,0,0,0
0,1563698705501259788,7,1,0.0,1,1,1,0,0,0.0,01/22/2023 09:46 PM,0,0,0
0,1673852317692131950,1,0,,1,1,1,0,0,0.0,01/22/2023 09:45 PM,0,0,0
0,1677249849598941300,1,0,,1,1,1,0,0,,01/22/2023 09:45 PM,0,0,0
1,1683527942170819570,0,0,0.0,1,1,1,1,0,0.0,01/22/2023 09:46 PM,0,1,0
0,1715823822654071770,1,0,,1,1,1,0,0,0.0,01/22/2023 09:45 PM,0,0,0
1,1674190450000407314,1,0,0.0,1,1,1,1,0,0.0,01/22/2023 09:47 PM,0,1,0
0,1677249767994562566,1,0,,1,1,1,0,0,0.0,01/22/2023 09:44 PM,0,0,0
0,1674190467180276532,1,0,,1,1,1,0,0,,01/22/2023 09:46 PM,0,0,0
0,1674190179417467196,1,0,,1,1,1,0,0,,01/22/2023 09:44 PM,0,0,0
0,1674190561669557204,3,0,,1,1,1,0,0,,01/22/2023 09:45 PM,0,0,0
0,1806753657092916062,2,0,,1,1,1,0,0,,05/01/2023 03:06 PM,0,0,0
0,1674190346921192042,1,0,,1,1,1,0,0,,01/22/2023 09:44 PM,0,0,0
0,1677249789469399070,2,0,,1,1,1,0,0,0.0,01/22/2023 09:46 PM,0,0,0
0,1674190450000407316,2,0,,1,1,1,0,0,,05/11/2023 11:06 AM,0,0,0
0,1674190282496682478,2,0,,1,1,1,0,0,,01/22/2023 09:45 PM,0,0,0
0,1695776978415481326,1,0,,1,1,1,0,0,,01/22/2023 09:47 PM,0,0,0
0,1674190626094066746,2,0,,1,1,1,0,0,0.0,01/22/2023 09:45 PM,0,0,0
0,1806753652797948740,2,0,,1,1,1,0,0,,05/01/2023 03:06 PM,0,0,0
2,1594046396693172926,7,0,0.0,1,1,1,2,0,0.0,01/22/2023 09:46 PM,0,2,0
0,1448642179437434486,5,1,,1,1,1,0,0,,01/22/2023 09:47 PM,0,0,0
0,1674190497245047652,1,0,,1,1,1,0,0,,01/22/2023 09:45 PM,0,0,0
0,1436495096608724634,4,0,,1,1,1,0,0,0.0,07/28/2022 03:40 PM,0,0,0
0,1677249772289529864,0,1,,1,1,1,0,0,0.0,01/22/2023 09:45 PM,0,0,0
1,1674190303971519000,0,0,0.0,1,1,1,1,0,0.0,01/22/2023 09:46 PM,0,1,0
0,1806753657092916052,2,0,,1,1,1,0,0,,05/03/2023 04:47 PM,0,0,0
0,1594046448262943690,8,0,0.0,1,1,1,0,0,1.0,01/22/2023 09:44 PM,0,0,0
0,1683527967940622362,1,0,0.0,1,1,1,0,0,2.0,01/22/2023 09:45 PM,0,0,0
1,1594041781399920506,7,1,0.0,1,1,1,1,0,0.0,01/22/2023 09:44 PM,0,1,0
1,1448642162257565286,0,0,0.0,1,1,1,1,0,0.0,01/22/2023 09:44 PM,0,1,0
0,1715823829734775370,1,0,,1,1,1,0,0,0.0,01/22/2023 09:46 PM,0,0,0
0,1674190475770211136,1,0,,1,1,1,0,0,0.0,01/22/2023 09:46 PM,0,0,0
0,1674190647568903268,1,0,,1,1,1,0,0,,01/22/2023 09:46 PM,0,0,0
8,1594041777104953202,1,0,0.0,1,1,1,8,0,0.0,01/22/2023 09:44 PM,0,8,0
0,1715846717333651852,2,0,,1,1,1,0,0,0.0,01/22/2023 09:47 PM,0,0,0
2,1571105055115583496,6,0,0.0,1,1,1,2,0,0.0,01/22/2023 09:44 PM,0,2,0
0,1806753657092916072,1,1,0.0,1,1,1,0,0,0.0,05/01/2023 03:06 PM,0,0,0
2,1674190432820538108,0,0,0.0,1,1,1,2,0,0.0,01/22/2023 09:46 PM,0,2,0
0,1806753661387883396,2,0,,1,1,1,0,0,,05/01/2023 03:06 PM,0,0,0
0,1806749744377709064,2,0,,1,1,1,0,0,,05/01/2023 02:51 PM,0,0,0
0,1594046388103238324,5,1,,1,1,1,0,0,0.0,01/22/2023 09:46 PM,0,0,0
0,1695777010841019090,1,1,,1,1,1,0,0,0.0,01/22/2023 09:44 PM,0,0,0
3,1806749747347777950,0,0,0.0,1,1,1,3,0,0.0,05/01/2023 02:51 PM,0,3,0
0,1674190381280930478,2,0,,1,1,1,0,0,0.0,01/22/2023 09:45 PM,0,0,0
0,1677249849598941296,2,0,,1,1,1,0,0,,01/22/2023 09:44 PM,0,0,0
0,1683527931525155818,2,0,,1,1,1,0,0,0.0,01/22/2023 09:46 PM,0,0,0
0,1594046379513303716,8,1,,1,1,1,0,0,0.0,01/22/2023 09:44 PM,0,0,0
0,1806749757262611012,2,1,0.0,1,1,1,0,0,0.0,05/01/2023 02:51 PM,0,0,0
0,1806753635618079462,2,0,,1,1,1,0,0,,05/01/2023 03:06 PM,0,0,0
0,1715823796884267962,1,0,,1,1,1,0,0,,01/22/2023 09:46 PM,0,0,0
1,1674190334036290140,0,0,0.0,1,1,1,1,0,0.0,01/22/2023 09:45 PM,0,1,0
0,1674190626094066752,1,0,,1,1,1,0,0,,01/22/2023 09:45 PM,0,0,0
0,1677249883958679718,1,0,,1,1,1,0,0,,01/22/2023 09:45 PM,0,0,0
0,1683527955055720454,1,0,,1,1,1,0,0,0.0,01/22/2023 09:44 PM,0,0,0
0,1806753644208014094,2,0,,1,1,1,0,0,,05/01/2023 03:06 PM,0,0,0
0,1674190604619230230,1,0,,1,1,1,0,0,0.0,01/22/2023 09:44 PM,0,0,0
0,1806753652797948730,2,0,,1,1,1,0,0,,05/01/2023 03:06 PM,0,0,0
0,1674190205187271014,2,0,,1,1,1,0,0,0.0,01/22/2023 09:46 PM,0,0,0
0,1806749748672676378,3,0,,1,1,1,0,0,,05/01/2023 02:51 PM,0,0,0
1,1806749731492807126,3,0,0.0,1,1,1,1,0,0.0,05/01/2023 02:51 PM,0,1,0
1,1674190462885309226,1,0,0.0,1,1,1,1,0,0.0,01/22/2023 09:46 PM,0,1,0
0,1674190321151388222,1,0,,1,1,1,0,0,,01/22/2023 09:46 PM,0,0,0
0,1806753657092916076,2,0,,1,1,1,0,0,,05/04/2023 12:46 PM,0,0,0
0,1806749761557578338,4,0,,1,1,1,0,0,,05/01/2023 02:51 PM,0,0,0
0,1674190621799099446,2,0,,1,1,1,0,0,0.0,01/22/2023 09:45 PM,0,0,0
0,1677249815239202876,1,0,,1,1,1,0,0,,01/22/2023 09:44 PM,0,0,0
0,1677249841009006690,1,0,,1,1,1,0,0,,01/22/2023 09:45 PM,0,0,0
0,1674190261021845960,1,0,,1,1,1,0,0,,01/22/2023 09:46 PM,0,0,0
0,1674190346921192048,1,0,,1,1,1,0,0,,01/22/2023 09:44 PM,0,0,0
4,1594046435347878644,5,0,0.0,1,1,1,4,0,0.0,05/22/2024 03:33 PM,0,4,0
0,1695776948350710232,3,0,,1,1,1,0,0,0.0,01/22/2023 09:44 PM,0,0,0
1,1806753639913046768,0,1,0.0,1,1,1,1,0,0.0,05/01/2023 03:06 PM,0,1,0
1,1575949519568499430,7,0,0.0,1,1,1,1,0,0.0,05/16/2023 09:37 AM,0,1,0
4,1582242285272847904,5,0,0.0,1,1,1,4,0,0.0,01/22/2023 09:44 PM,0,4,0
0,1674190368396028562,1,1,,1,1,1,0,0,,01/22/2023 09:44 PM,0,0,0
0,1715823791080069664,1,0,,1,1,1,0,0,,01/22/2023 09:46 PM,0,0,0
0,1806749731492807128,2,0,,1,1,1,0,0,,05/01/2023 02:51 PM,0,0,0
0,1806749722902872506,4,0,,1,1,1,0,0,,05/01/2023 02:51 PM,0,0,0
0,1806749727197839822,4,0,,1,1,1,0,0,,05/01/2023 02:51 PM,0,0,0
0,1806749757262611036,2,0,,1,1,1,0,0,,05/01/2023 02:51 PM,0,0,0
0,1674190376985963172,1,0,,1,1,1,0,0,,01/22/2023 09:45 PM,0,0,0
0,1677249845303973996,1,0,,1,1,1,0,0,,01/22/2023 09:44 PM,0,0,0
0,1677249785174431768,2,0,,1,1,1,0,0,,01/22/2023 09:45 PM,0,0,0
0,1674190183712434502,1,0,,1,1,1,0,0,,01/22/2023 09:46 PM,0,0,0
0,1806749748672676392,4,0,,1,1,1,0,0,,05/01/2023 02:51 PM,0,0,0
0,1674190540194720686,1,0,,1,1,1,0,0,,01/22/2023 09:44 PM,0,0,0
0,1715823812554906158,1,0,,1,1,1,0,0,,01/22/2023 09:45 PM,0,0,0
0,1806753648502981402,2,0,,1,1,1,0,0,,05/01/2023 03:06 PM,0,0,0
0,1674190239547009454,1,0,,1,1,1,0,0,0.0,01/22/2023 09:45 PM,0,0,0
0,1594046383808271020,9,0,0.0,1,1,1,0,0,1.0,01/22/2023 09:45 PM,0,0,0
0,1674190359806093958,1,0,,1,1,1,0,0,,01/22/2023 09:46 PM,0,0,0
0,1674190278201715174,2,0,,1,1,1,0,0,,01/22/2023 09:47 PM,0,0,0
3,1594041785694887806,2,1,0.0,1,1,1,3,0,0.0,01/22/2023 09:46 PM,0,3,0
0,1806753664357952126,2,0,,1,1,1,0,0,,05/01/2023 03:06 PM,0,0,0
2,1806753652797948728,0,0,0.0,1,1,1,2,0,0.0,05/04/2023 12:49 PM,0,2,0
0,1695776938005109486,1,0,0.0,1,1,1,0,0,1.0,01/22/2023 09:46 PM,0,0,0
0,1806749731492807144,2,0,,1,1,1,0,0,,05/01/2023 02:51 PM,0,0,0
0,1806749718607905176,4,0,,1,1,1,0,0,,05/01/2023 02:51 PM,0,0,0
1,1683527927230188516,0,0,0.0,1,1,1,1,0,0.0,01/22/2023 09:44 PM,0,1,0
0,1806749731492807142,10,0,,1,1,1,0,0,,05/01/2023 02:51 PM,0,0,0
0,1806753639913046772,2,0,,1,1,1,0,0,,05/01/2023 03:06 PM,0,0,0
1,1674190484360145746,0,0,0.0,1,1,1,1,0,0.0,01/22/2023 09:44 PM,0,1,0
0,1806753631323112128,2,0,,1,1,1,0,0,,05/01/2023 03:06 PM,0,0,0
0,1674190471475243832,1,0,,1,1,1,0,0,,01/22/2023 09:46 PM,0,0,0
2,1674190170827532590,0,1,0.0,1,1,1,2,0,1.0,01/22/2023 09:44 PM,0,2,0
0,1674190140762761460,1,0,,1,1,1,0,0,,01/22/2023 09:45 PM,0,0,0
0,1677249888253647022,1,0,,1,1,1,0,0,,01/22/2023 09:45 PM,0,0,0
0,1806753631323112148,2,0,,1,1,1,0,0,,05/01/2023 03:06 PM,0,0,0
0,1674190634684001356,2,0,,1,1,1,0,0,0.0,01/22/2023 09:46 PM,0,0,0
0,1674190222367140228,2,0,,1,1,1,0,0,,01/22/2023 09:44 PM,0,0,0
0,1674190484360145744,2,0,,1,1,1,0,0,0.0,01/22/2023 09:46 PM,0,0,0
0,1683527937875852272,1,0,,1,1,1,0,0,,01/22/2023 09:47 PM,0,0,0
0,1683527937875852268,1,0,,1,1,1,0,0,,01/22/2023 09:46 PM,0,0,0
0,1715846713038684540,1,0,,1,1,1,0,0,0.0,01/22/2023 09:45 PM,0,0,0
0,1806749718607905156,2,0,,1,1,1,0,0,,05/01/2023 02:51 PM,0,0,0
1,1674190252431911356,0,0,0.0,1,1,1,1,0,0.0,01/22/2023 09:46 PM,0,1,0
1,1674190415640668880,2,0,0.0,1,1,1,1,0,0.0,01/22/2023 09:44 PM,0,1,0
0,1806753638588148344,2,0,,1,1,1,0,0,,05/01/2023 03:06 PM,0,0,0
0,1677249785174431770,0,1,,1,1,1,0,0,0.0,01/22/2023 09:46 PM,0,0,0
0,1674190175122499898,1,1,,1,1,1,0,0,,01/22/2023 09:45 PM,0,0,0
0,1806753665682850716,2,0,,1,1,1,0,0,0.0,05/01/2023 03:06 PM,0,0,0
0,1674190291086617084,2,0,,1,1,1,0,0,,01/22/2023 09:46 PM,0,0,0
1,1674190467180276534,0,0,0.0,1,1,1,1,0,0.0,01/22/2023 09:45 PM,0,1,0
0,1674190467180276528,1,0,,1,1,1,0,0,,01/22/2023 09:46 PM,0,0,0
0,1695780087377656306,1,0,0.0,1,1,1,0,0,2.0,01/22/2023 09:47 PM,0,0,0
0,1674190239547009456,0,1,,1,1,1,0,0,0.0,01/22/2023 09:46 PM,0,0,0
0,1674190514424916872,2,0,,1,1,1,0,0,,01/22/2023 09:45 PM,0,0,0
0,1674190686223609002,1,0,,1,1,1,0,0,,01/22/2023 09:47 PM,0,0,0
0,1674190239547009458,5,1,0.0,1,1,1,0,0,0.0,01/22/2023 09:44 PM,0,0,0
0,1674190265316813264,1,0,,1,1,1,0,0,,01/22/2023 09:46 PM,0,0,0
0,1806753639913046780,2,0,,1,1,1,0,0,,05/01/2023 03:06 PM,0,0,0
0,1683527972235589666,0,1,,1,1,1,0,0,0.0,01/22/2023 09:46 PM,0,0,0
0,1806749744377709060,2,0,,1,1,1,0,0,,05/01/2023 02:51 PM,0,0,0
1,1674190557374589902,3,0,0.0,1,1,1,1,0,1.0,01/22/2023 09:44 PM,0,1,0
0,1674190544489687992,2,0,,1,1,1,0,0,,01/22/2023 09:45 PM,0,0,0
0,1674190355511126652,2,0,,1,1,1,0,0,0.0,01/22/2023 09:46 PM,0,0,0
0,1715846704448749936,1,0,,1,1,1,0,0,0.0,01/22/2023 09:47 PM,0,0,0
0,1674190454295374622,1,0,,1,1,1,0,0,,01/22/2023 09:44 PM,0,0,0
0,1674190334036290136,5,1,,1,1,1,0,0,0.0,01/22/2023 09:45 PM,0,0,0
0,1806749757262611032,2,0,,1,1,1,0,0,,05/01/2023 02:51 PM,0,0,0
0,1674190578849426420,2,0,,1,1,1,0,0,0.0,01/22/2023 09:47 PM,0,0,0
0,1674190213777205626,10,0,0.0,1,1,1,0,0,1.0,01/22/2023 09:45 PM,0,0,0
0,1674190381280930480,2,0,,1,1,1,0,0,0.0,01/22/2023 09:45 PM,0,0,0
3,1594046400988140226,5,0,0.0,1,1,1,3,0,0.0,01/22/2023 09:45 PM,0,3,0
3,1594046443937813244,3,2,0.0,1,1,1,3,0,0.0,01/22/2023 09:44 PM,0,3,0
0,1674190243841976756,2,0,,1,1,1,0,0,0.0,01/22/2023 09:45 PM,0,0,0
0,1806753629998213750,4,0,,1,1,1,0,0,,05/01/2023 03:06 PM,0,0,0
0,1695776956346497674,1,0,,1,1,1,0,0,,01/22/2023 09:46 PM,0,0,0
0,1827484051430132402,4,0,,1,1,1,0,0,,06/26/2023 11:51 AM,0,0,0
0,1806749748672676384,4,0,,1,1,1,0,0,,05/04/2023 01:12 PM,0,0,0
0,1806749752967643712,2,0,,1,1,1,0,0,,05/01/2023 02:51 PM,0,0,0
0,1674190557374589898,3,0,,1,1,1,0,0,0.0,01/22/2023 09:44 PM,0,0,0
0,1806753669977818020,2,0,,1,1,1,0,0,,05/01/2023 03:06 PM,0,0,0
0,1674190570259491812,2,0,,1,1,1,0,0,,01/22/2023 09:44 PM,0,0,0
0,1677249871073777806,2,0,,1,1,1,0,0,0.0,01/22/2023 09:47 PM,0,0,0
1,1674190437115505412,1,0,0.0,1,1,1,1,0,0.0,01/22/2023 09:47 PM,0,1,0
0,1674190411345701582,1,0,,1,1,1,0,0,0.0,01/22/2023 09:46 PM,0,0,0
0,1674190351216159354,9,0,,1,1,1,0,0,,01/22/2023 09:45 PM,0,0,0
0,1674190321151388220,3,0,,1,1,1,0,0,,01/22/2023 09:45 PM,0,0,0
0,1674190213777205624,1,0,,1,1,1,0,0,0.0,01/22/2023 09:44 PM,0,0,0
0,1695776956940644828,1,0,,1,1,1,0,0,,01/22/2023 09:45 PM,0,0,0
0,1695776985249749776,0,1,,1,1,1,0,0,,01/22/2023 09:46 PM,0,0,0
0,1674190338331257438,3,0,,1,1,1,0,0,0.0,01/22/2023 09:45 PM,0,0,0
0,1695776991300383220,1,0,,1,1,1,0,0,,01/22/2023 09:44 PM,0,0,0
0,1695776969825546724,1,0,,1,1,1,0,0,,01/22/2023 09:44 PM,0,0,0
0,1806749757262611020,2,0,,1,1,1,0,0,,05/04/2023 01:08 PM,0,0,0
0,1695780083082689004,2,0,,1,1,1,0,0,0.0,01/22/2023 09:45 PM,0,0,0
0,1674190480065178436,1,0,,1,1,1,0,0,0.0,01/22/2023 09:47 PM,0,0,0
0,1674190643273935964,1,0,,1,1,1,0,0,,01/22/2023 09:46 PM,0,0,0
0,1674190364101061264,2,0,,1,1,1,0,0,,01/22/2023 09:44 PM,0,0,0
0,1683527957294958598,1,0,,1,1,1,0,0,0.0,01/22/2023 09:44 PM,0,0,0
0,1806753639913046764,2,0,,1,1,1,0,0,,05/01/2023 03:06 PM,0,0,0
0,1674190303971518998,2,0,,1,1,1,0,0,,01/22/2023 09:46 PM,0,0,0
0,1674190175122499894,2,0,,1,1,1,0,0,0.0,01/22/2023 09:46 PM,0,0,0
0,1806753652797948722,2,0,,1,1,1,0,0,,05/01/2023 03:06 PM,0,0,0
0,1674190312561453608,1,0,,1,1,1,0,0,,01/22/2023 09:47 PM,0,0,0
1,1674190488655113046,1,0,0.0,1,1,1,1,0,0.0,01/22/2023 09:45 PM,0,1,0
0,1677249841009006688,1,0,,1,1,1,0,0,,01/22/2023 09:46 PM,0,0,0
0,1674190346921192050,6,0,,1,1,1,0,0,0.0,01/22/2023 09:46 PM,0,0,0
2,1677249858188875902,0,1,0.0,1,1,1,2,0,0.0,01/22/2023 09:45 PM,0,2,0
0,1594046431052911340,8,1,0.0,1,1,1,0,0,0.0,01/22/2023 09:44 PM,0,0,0
0,1806749757262611010,2,0,,1,1,1,0,0,,05/01/2023 02:51 PM,0,0,0
1,1806749744377709068,10,0,0.0,1,1,1,1,0,0.0,05/01/2023 02:51 PM,0,1,0
0,1806749727197839814,4,0,,1,1,1,0,0,,05/04/2023 12:51 PM,0,0,0
0,1968523977248219732,50,0,,1,1,1,0,0,0.0,07/26/2024 08:12 PM,0,0,0
4,1563698718386161690,1,3,0.0,1,1,1,4,0,1.0,01/22/2023 09:45 PM,0,4,0
1,1683527972235589660,0,0,0.0,1,1,1,1,0,0.0,01/22/2023 09:46 PM,0,1,0
0,1674190381280930476,2,0,,1,1,1,0,0,,01/22/2023 09:45 PM,0,0,0
0,1695777008480252434,2,0,,1,1,1,0,0,0.0,01/22/2023 09:45 PM,0,0,0
0,1715823826949039076,1,0,,1,1,1,0,0,0.0,01/22/2023 09:45 PM,0,0,0
0,1695777002429618974,1,0,,1,1,1,0,0,,01/22/2023 09:46 PM,0,0,0
0,1677249836714039390,1,0,,0,1,0,0,0,,06/22/2023 09:44 AM,0,0,0
0,1715823822654071768,2,0,,1,1,1,0,0,0.0,01/22/2023 09:47 PM,0,0,0
0,1674190450000407318,2,0,,1,1,1,0,0,,05/11/2023 11:18 AM,0,0,0
0,1674190170827532586,0,1,,1,1,1,0,0,0.0,01/22/2023 09:46 PM,0,0,0
0,1677249802354300976,1,0,,1,1,1,0,0,,01/22/2023 09:47 PM,0,0,0
0,1674190286791649782,2,0,,1,1,1,0,0,,01/22/2023 09:44 PM,0,0,0
0,1674190497245047656,2,1,0.0,1,1,1,0,0,0.0,01/22/2023 09:45 PM,0,0,0
0,1674190265316813262,1,0,,1,1,1,0,0,,01/22/2023 09:46 PM,0,0,0
0,1806749744377709058,2,0,,1,1,1,0,0,,05/01/2023 02:51 PM,0,0,0
3,1561012883010990646,4,1,0.0,1,1,1,3,0,0.0,05/04/2023 01:30 PM,0,3,0
0,1806753648502981418,2,0,,1,1,1,0,0,,05/01/2023 03:06 PM,0,0,0
0,1436495122378528446,6,0,,1,1,1,0,0,0.0,01/22/2023 09:46 PM,0,0,0
2,1571105055115583500,6,0,0.0,1,1,1,2,0,0.0,01/22/2023 09:45 PM,0,2,0
0,1674190587439361022,4,0,,1,1,1,0,0,0.0,01/22/2023 09:46 PM,0,0,0
0,1715823829734775372,1,0,0.0,1,1,1,0,0,1.0,01/22/2023 09:47 PM,0,0,0
2,1806749748672676390,0,1,0.0,1,1,1,2,0,0.0,05/01/2023 02:51 PM,0,2,0
0,1674190145057728766,2,0,,1,1,1,0,0,,01/22/2023 09:46 PM,0,0,0
0,1677249853893908600,2,0,,1,1,1,0,0,0.0,01/22/2023 09:47 PM,0,0,0
9,1521679584953491780,0,0,0.0,1,1,1,9,0,0.0,01/22/2023 09:44 PM,0,9,0
0,1715846700153782636,2,0,,1,1,1,0,0,0.0,01/22/2023 09:45 PM,0,0,0
0,1677249785174431766,1,0,,1,1,1,0,0,,01/22/2023 09:44 PM,0,0,0
0,1500206163166594382,9,0,0.0,1,1,1,0,0,2.0,05/25/2023 04:29 PM,0,0,0
0,1806749752967643708,3,0,,1,1,1,0,0,,05/01/2023 02:51 PM,0,0,0
0,1683527959350687752,1,0,,1,1,1,0,0,,01/22/2023 09:47 PM,0,0,0
0,1674190222367140232,8,0,,1,1,1,0,0,0.0,01/22/2023 09:45 PM,0,0,0
1,1674190256726878654,0,0,0.0,1,1,1,1,0,0.0,01/22/2023 09:47 PM,0,1,0
0,1674190166532565276,2,0,,1,1,1,0,0,0.0,01/22/2023 09:45 PM,0,0,0
0,1674190531604786074,0,1,0.0,1,1,1,0,0,0.0,01/22/2023 09:45 PM,0,0,0
4,1806753644208014088,0,1,0.0,1,1,1,4,0,0.0,05/01/2023 03:06 PM,0,4,0
0,1677249798059333678,1,0,,1,1,1,0,0,,01/22/2023 09:46 PM,0,0,0
0,1521686986436309688,11,1,0.0,1,1,1,0,0,0.0,05/25/2023 04:32 PM,0,0,0
0,1674190492950080346,2,0,,1,1,1,0,0,0.0,01/22/2023 09:45 PM,0,0,0
0,1674190196597336410,2,0,,1,1,1,0,0,,01/22/2023 09:47 PM,0,0,0
0,1695777004185285124,3,0,,1,1,1,0,0,0.0,01/22/2023 09:45 PM,0,0,0
3,1806753652797948752,0,2,0.0,1,1,1,3,0,0.0,05/01/2023 03:06 PM,0,3,0
0,1806749752967643704,2,0,,1,1,1,0,0,,05/01/2023 02:51 PM,0,0,0
0,1674190540194720688,1,0,,1,1,1,0,0,,01/22/2023 09:46 PM,0,0,0
0,1674190669043739798,1,0,,1,1,1,0,0,,01/22/2023 09:46 PM,0,0,0
2,1677249802354300980,2,0,0.0,1,1,1,2,0,0.0,01/22/2023 09:46 PM,0,2,0
0,1674190638978968660,1,0,,1,1,1,0,0,,01/22/2023 09:46 PM,0,0,0
0,1806753652797948746,2,0,,1,1,1,0,0,,05/01/2023 03:06 PM,0,0,0
0,1806749755937712544,2,0,,1,1,1,0,0,,05/01/2023 02:51 PM,0,0,0
0,1683527959350687758,2,0,,1,1,1,0,0,0.0,01/22/2023 09:47 PM,0,0,0
0,1674190497245047650,1,0,,1,1,1,0,0,,01/22/2023 09:47 PM,0,0,0
0,1715846705501012844,2,0,,1,1,1,0,0,0.0,01/22/2023 09:45 PM,0,0,0
0,1674190544489687988,1,0,,1,1,1,0,0,,01/22/2023 09:44 PM,0,0,0
0,1806749752967643710,2,0,,1,1,1,0,0,,05/01/2023 02:51 PM,0,0,0
1,1674190291086617088,0,0,0.0,1,1,1,1,0,0.0,01/22/2023 09:44 PM,0,1,0
0,1695776985071215288,1,0,,1,1,1,0,0,,01/22/2023 09:44 PM,0,0,0
0,1674190286791649780,3,0,,1,1,1,0,0,,01/22/2023 09:46 PM,0,0,0
1,1677249879663712420,1,0,0.0,1,1,1,1,0,0.0,01/22/2023 09:45 PM,0,1,0
0,1674190553079622598,1,0,,1,1,1,0,0,,01/22/2023 09:47 PM,0,0,0
0,1806753639913046778,2,0,,1,1,1,0,0,,05/01/2023 03:06 PM,0,0,0
0,1806753655768017532,1,1,,1,1,1,0,0,,05/01/2023 03:06 PM,0,0,0
0,1674190634684001358,2,1,,1,1,1,0,0,0.0,01/22/2023 09:45 PM,0,0,0
0,1674190458590341928,1,0,,1,1,1,0,0,0.0,01/22/2023 09:44 PM,0,0,0
0,1674190256726878658,2,0,,1,1,1,0,0,0.0,01/22/2023 09:45 PM,0,0,0
8,1594046405283107532,1,0,0.0,1,1,1,8,0,0.0,01/22/2023 09:45 PM,0,8,0
0,1674190694813543600,3,0,,1,1,1,0,0,0.0,01/22/2023 09:44 PM,0,0,0
0,1715823805474202572,1,0,,1,1,1,0,0,,01/22/2023 09:47 PM,0,0,0
2,1448642183732401788,5,0,0.0,1,1,1,2,0,0.0,01/22/2023 09:45 PM,0,2,0
0,1806749727197839810,2,0,,1,1,1,0,0,,05/09/2023 11:48 AM,0,0,0
0,1715823821144840768,2,0,,1,1,1,0,0,0.0,01/22/2023 09:47 PM,0,0,0
1,1674190617504132140,3,0,0.0,1,1,1,1,0,0.0,01/22/2023 09:44 PM,0,1,0
0,1674190424230603488,1,0,,1,1,1,0,0,0.0,01/22/2023 09:47 PM,0,0,0
2,1674190329741322834,1,0,0.0,1,1,1,2,0,1.0,01/22/2023 09:45 PM,0,2,0
3,1806749722902872498,0,1,0.0,1,1,1,3,0,0.0,05/09/2023 11:42 AM,0,3,0
1,1674190179417467200,0,0,0.0,1,1,1,1,0,0.0,01/22/2023 09:47 PM,0,1,0
0,1674190664748772492,2,0,,1,1,1,0,0,,01/22/2023 09:44 PM,0,0,0
0,1674190591734328326,1,0,,1,1,1,0,0,,01/22/2023 09:44 PM,0,0,0
6,1593766343243326364,2,1,0.0,1,1,1,6,0,0.0,01/22/2023 09:45 PM,0,6,0
0,1674190643273935966,0,1,,1,1,1,0,0,,01/22/2023 09:45 PM,0,0,0
0,1674190583144393720,1,0,,1,1,1,0,0,0.0,01/22/2023 09:45 PM,0,0,0
0,1674190364101061260,1,0,,1,1,1,0,0,0.0,01/22/2023 09:44 PM,0,0,0
0,1674190278201715178,1,0,,1,1,1,0,0,,01/22/2023 09:46 PM,0,0,0
0,1674190600324262932,1,0,,1,1,1,0,0,0.0,01/22/2023 09:47 PM,0,0,0
0,1674190196597336406,1,0,,1,1,1,0,0,,01/22/2023 09:46 PM,0,0,0
0,1674190372690995868,1,0,,1,1,1,0,0,0.0,01/22/2023 09:45 PM,0,0,0
3,1563698688321392630,5,0,0.0,1,1,1,3,0,2.0,01/22/2023 09:44 PM,0,3,0
0,1683527931525155816,1,0,,1,1,1,0,0,,01/22/2023 09:45 PM,0,0,0
0,1806753635618079454,2,0,,1,1,1,0,0,,05/01/2023 03:06 PM,0,0,0
0,1677249776584497168,2,0,,1,1,1,0,0,0.0,01/22/2023 09:47 PM,0,0,0
0,1674190587439361024,1,0,,1,1,1,0,0,0.0,01/22/2023 09:44 PM,0,0,0
0,1806749744377709066,2,0,,1,1,1,0,0,0.0,05/01/2023 02:51 PM,0,0,0
1,1674190553079622600,0,1,0.0,1,1,1,1,0,0.0,01/22/2023 09:44 PM,0,1,0
0,1674190553079622596,1,0,,1,1,1,0,0,,01/22/2023 09:46 PM,0,0,0
0,1695776980954782472,1,1,,1,1,1,0,0,,01/22/2023 09:45 PM,0,0,0
0,1674190462885309230,2,0,,1,1,1,0,0,0.0,01/22/2023 09:47 PM,0,0,0
0,1695777019609488196,3,0,0.0,1,1,1,0,0,2.0,01/22/2023 09:45 PM,0,0,0
0,1674190656158837890,4,0,,1,1,1,0,0,,01/22/2023 09:44 PM,0,0,0
0,1674190505834982260,1,0,,1,1,1,0,0,,01/22/2023 09:44 PM,0,0,0
0,1968523931105227248,48,2,0.0,1,1,1,0,0,1.0,07/26/2024 08:12 PM,0,0,0
0,1674190295381584396,1,0,,1,1,1,0,0,,01/22/2023 09:46 PM,0,0,0
0,1674190325446355526,1,0,,1,1,1,0,0,0.0,01/22/2023 09:44 PM,0,0,0
7,1575949510978564828,0,1,0.0,1,1,1,7,0,0.0,01/22/2023 09:47 PM,0,7,0
0,1674190604619230232,6,0,,1,1,1,0,0,0.0,01/22/2023 09:45 PM,0,0,0
0,1673852326282066544,1,0,,1,1,1,0,0,0.0,01/22/2023 09:46 PM,0,0,0
0,1695776963774913278,1,0,,1,1,1,0,0,,01/22/2023 09:46 PM,0,0,0
0,1674190535899753386,2,1,0.0,1,1,1,0,0,0.0,01/22/2023 09:47 PM,0,0,0
0,1695780087377656308,1,0,,1,1,1,0,0,0.0,01/22/2023 09:47 PM,0,0,0
0,1674190638978968664,1,0,,1,1,1,0,0,,01/22/2023 09:47 PM,0,0,0
0,1806753648502981416,2,0,,1,1,1,0,0,,05/01/2023 03:06 PM,0,0,0
1,1677249883958679722,0,0,0.0,1,1,1,1,0,0.0,01/22/2023 09:46 PM,0,1,0
0,1677249832419072086,1,1,0.0,1,1,1,0,0,0.0,01/22/2023 09:45 PM,0,0,0
0,1674190561669557206,2,0,,1,1,1,0,0,,01/22/2023 09:45 PM,0,0,0
0,1806749757262611014,4,0,,1,1,1,0,0,,05/04/2023 01:03 PM,0,0,0
0,1674190368396028568,1,0,,1,1,1,0,0,,01/22/2023 09:45 PM,0,0,0
0,1677249849598941294,1,0,,1,1,1,0,0,,01/22/2023 09:45 PM,0,0,0
1,1827474404723843684,0,0,0.0,1,1,1,1,0,0.0,06/26/2023 11:14 AM,0,1,0
0,1674190334036290138,3,0,,1,1,1,0,0,0.0,01/22/2023 09:47 PM,0,0,0
0,1674190407050734270,9,1,,1,1,1,0,0,,01/22/2023 09:44 PM,0,0,0
0,1677249780879464466,1,0,,1,1,1,0,0,0.0,01/22/2023 09:45 PM,0,0,0
0,1674190540194720684,1,0,,1,1,1,0,0,,01/22/2023 09:45 PM,0,0,0
0,1674190218072172928,0,2,,1,1,1,0,0,0.0,01/22/2023 09:45 PM,0,0,0
1,1695776948350710230,0,0,0.0,1,1,1,1,0,0.0,01/22/2023 09:44 PM,0,1,0
0,1674190510129949570,6,0,,1,1,1,0,0,0.0,01/22/2023 09:45 PM,0,0,0
0,1674190574554459112,1,0,,1,1,1,0,0,,01/22/2023 09:45 PM,0,0,0
0,1695780083082689008,9,0,,1,1,1,0,0,0.0,01/22/2023 09:46 PM,0,0,0
0,1674190136467794156,2,0,,1,1,1,0,0,,01/22/2023 09:47 PM,0,0,0
0,1674190162237597978,1,0,,1,1,1,0,0,0.0,01/22/2023 09:44 PM,0,0,0
0,1677249772289529870,1,0,,1,1,1,0,0,0.0,01/22/2023 09:45 PM,0,0,0
0,1674190428525570794,0,1,,1,1,1,0,0,,01/22/2023 09:45 PM,0,0,0
0,1677249793764366374,5,0,,1,1,1,0,0,,01/22/2023 09:45 PM,0,0,0
1,1674190617504132138,0,1,0.0,1,1,1,1,0,0.0,01/22/2023 09:45 PM,0,1,0
0,1677249815239202874,1,0,,1,1,1,0,0,,01/22/2023 09:47 PM,0,0,0
0,1753333909108677614,6,0,,0,1,0,0,0,0.0,04/20/2023 04:48 PM,0,0,0
0,1806749752967643696,4,0,,1,1,1,0,0,0.0,05/01/2023 02:51 PM,0,0,0
1,1674190170827532584,0,0,0.0,1,1,1,1,0,0.0,01/22/2023 09:44 PM,0,1,0
0,1674190445705440014,1,1,,1,1,1,0,0,0.0,01/22/2023 09:47 PM,0,0,0
0,1674190162237597974,1,0,,1,1,1,0,0,0.0,01/22/2023 09:46 PM,0,0,0
0,1674190630389034058,2,0,,1,1,1,0,0,0.0,01/22/2023 09:46 PM,0,0,0
0,1806749727197839808,2,0,,1,1,1,0,0,,05/09/2023 11:42 AM,0,0,0
0,1806753665682850708,2,0,,1,1,1,0,0,,05/01/2023 03:06 PM,0,0,0
0,1674190578849426418,2,0,,1,1,1,0,0,0.0,01/22/2023 09:46 PM,0,0,0
0,1677249866778810506,1,0,,1,1,1,0,0,0.0,01/22/2023 09:45 PM,0,0,0
0,1674190325446355528,0,1,,1,1,1,0,0,0.0,01/22/2023 09:44 PM,0,0,0
3,1582242289567815208,3,0,0.0,1,1,1,3,0,0.0,01/22/2023 09:46 PM,0,3,0
0,1806753631323112142,2,0,,1,1,1,0,0,,05/01/2023 03:06 PM,0,0,0
3,1594046439642845942,2,0,0.0,1,1,1,3,0,0.0,01/22/2023 09:46 PM,0,3,0
0,1674190243841976758,2,0,0.0,1,1,1,0,0,1.0,05/08/2023 09:37 AM,0,0,0
0,1674190617504132142,2,0,,1,1,1,0,0,0.0,01/22/2023 09:45 PM,0,0,0
0,1674190462885309228,1,1,,1,1,1,0,0,,01/22/2023 09:47 PM,0,0,0
0,1806749734462876060,4,0,,1,1,1,0,0,,05/01/2023 02:51 PM,0,0,0
1,1806753635618079458,1,0,0.0,1,1,1,1,0,0.0,05/01/2023 03:06 PM,0,1,0
0,1677249828124104782,1,0,,1,1,1,0,0,,01/22/2023 09:45 PM,0,0,0
0,1674190218072172926,2,0,,1,1,1,0,0,,01/22/2023 09:44 PM,0,0,0
0,1674190308266486300,1,0,,1,1,1,0,0,0.0,01/22/2023 09:46 PM,0,0,0
0,1715846714090947442,1,0,,1,1,1,0,0,0.0,01/22/2023 09:46 PM,0,0,0
0,1683527927230188514,1,0,,1,1,1,0,0,0.0,01/22/2023 09:44 PM,0,0,0
3,1594046418168009436,5,0,0.0,1,1,1,3,0,0.0,01/22/2023 09:44 PM,0,3,0
1,1806749748672676386,1,0,0.0,1,1,1,1,0,0.0,05/01/2023 02:51 PM,0,1,0
0,1806753669977818026,2,0,,1,1,1,0,0,,05/09/2023 11:49 AM,0,0,0
2,1594046426757944042,0,2,0.0,1,1,1,2,0,1.0,01/22/2023 09:45 PM,0,2,0
0,1695776995595350522,2,0,,1,1,1,0,0,,01/22/2023 09:47 PM,0,0,0
5,1594041777104953206,5,0,0.0,1,1,1,5,0,0.0,01/22/2023 09:47 PM,0,5,0
0,1677249866778810508,2,0,,1,1,1,0,0,0.0,01/22/2023 09:45 PM,0,0,0
0,1806753639913046770,2,0,,1,1,1,0,0,,05/01/2023 03:06 PM,0,0,0
0,1677249828124104786,1,0,,1,1,1,0,0,,01/22/2023 09:45 PM,0,0,0
0,1674190261021845962,1,0,,1,1,1,0,0,,01/22/2023 09:46 PM,0,0,0
0,1677249772289529866,1,0,,1,1,1,0,0,0.0,01/22/2023 09:45 PM,0,0,0
0,1674190385575897778,1,0,0.0,1,1,1,0,0,1.0,01/22/2023 09:47 PM,0,0,0
0,1677249871073777808,1,0,,1,1,1,0,0,0.0,01/22/2023 09:45 PM,0,0,0
0,1695776969825546726,1,0,,1,1,1,0,0,,01/22/2023 09:47 PM,0,0,0
0,1674190192302369104,1,0,,1,1,1,0,0,0.0,01/22/2023 09:45 PM,0,0,0
0,1674190428525570798,10,0,,1,1,1,0,0,,01/22/2023 09:45 PM,0,0,0
0,1806753648502981400,4,0,,1,1,1,0,0,,05/01/2023 03:06 PM,0,0,0
0,1674190419935636188,2,0,,1,1,1,0,0,0.0,01/22/2023 09:46 PM,0,0,0
0,1677249798059333674,1,0,,1,1,1,0,0,,01/22/2023 09:44 PM,0,0,0
1,1715823801179235264,0,0,0.0,1,1,1,1,0,0.0,01/22/2023 09:45 PM,0,1,0
0,1674190407050734268,3,0,,1,1,1,0,0,0.0,01/22/2023 09:46 PM,0,0,0
0,1806753648502981414,2,0,,1,1,1,0,0,,05/01/2023 03:06 PM,0,0,0
0,1715823783999366064,1,0,,1,1,1,0,0,,01/22/2023 09:44 PM,0,0,0
0,1806749752967643706,2,2,0.0,1,1,1,0,0,0.0,05/01/2023 02:51 PM,0,0,0
1,1594046418168009438,8,0,0.0,1,1,1,1,0,0.0,01/22/2023 09:44 PM,0,1,0
0,1436495119852630436,6,0,0.0,1,1,1,0,0,2.0,05/12/2023 09:31 AM,0,0,0
0,1436495109493626544,9,0,,1,1,1,0,0,0.0,05/25/2023 04:30 PM,0,0,0
0,1674190548784655292,1,1,0.0,1,1,1,0,0,0.0,01/22/2023 09:45 PM,0,0,0
0,1582242323927553626,0,3,,1,1,1,0,0,,01/22/2023 09:46 PM,0,0,0
0,1677249875368745112,1,0,,1,1,1,0,0,,01/22/2023 09:44 PM,0,0,0
0,1806749718607905162,2,0,,1,1,1,0,0,,05/01/2023 02:51 PM,0,0,0
1,1715846713038684536,0,0,0.0,1,1,1,1,0,0.0,01/22/2023 09:44 PM,0,1,0
0,1715823816849873466,1,0,,1,1,1,0,0,0.0,01/22/2023 09:44 PM,0,0,0
0,1674190523014851472,1,0,,1,1,1,0,0,0.0,01/22/2023 09:47 PM,0,0,0
3,1674190179417467202,0,0,0.0,1,1,1,3,0,0.0,01/22/2023 09:44 PM,0,3,0
0,1806749740082741756,4,0,,1,1,1,0,0,,05/01/2023 02:51 PM,0,0,0
0,1674190673338707102,1,0,,1,1,1,0,0,0.0,01/22/2023 09:46 PM,0,0,0
0,1806749748672676382,2,0,,1,1,1,0,0,,05/03/2023 03:55 PM,0,0,0
0,1806753661387883394,2,0,,1,1,1,0,0,,05/01/2023 03:06 PM,0,0,0
1,1674190295381584392,0,1,0.0,1,1,1,1,0,0.0,01/22/2023 09:46 PM,0,1,0
0,1673852313397164652,1,0,,1,1,1,0,0,0.0,01/22/2023 09:47 PM,0,0,0
0,1674190149352696064,1,0,,1,1,1,0,0,,01/22/2023 09:46 PM,0,0,0
0,1674190364101061262,2,0,,1,1,1,0,0,0.0,01/22/2023 09:46 PM,0,0,0
0,1806753661387883382,2,0,,1,1,1,0,0,,05/01/2023 03:06 PM,0,0,0
2,1594046448232780548,7,0,0.0,1,1,1,2,0,0.0,01/22/2023 09:44 PM,0,2,0
0,1674190295381584388,2,0,,1,1,1,0,0,0.0,01/22/2023 09:47 PM,0,0,0
2,1594046448232780546,6,0,0.0,1,1,1,2,0,0.0,01/22/2023 09:46 PM,0,2,0
0,1827484051430132400,1,0,,1,1,1,0,0,,06/26/2023 11:51 AM,0,0,0
0,1677249789469399068,0,1,0.0,1,1,1,0,0,0.0,01/22/2023 09:46 PM,0,0,0
0,1806749740082741754,2,0,,1,1,1,0,0,,05/01/2023 02:51 PM,0,0,0
0,1806749722902872494,2,0,,1,1,1,0,0,,05/01/2023 02:51 PM,0,0,0
2,1563698684026425330,7,0,0.0,1,1,1,2,0,0.0,01/22/2023 09:46 PM,0,2,0
3,1594046413873042132,5,1,0.0,1,1,1,3,0,4.0,01/22/2023 09:44 PM,0,3,0
0,1806749740082741752,2,0,,1,1,1,0,0,,05/01/2023 02:51 PM,0,0,0
0,1806749731492807138,4,0,,1,1,1,0,0,,05/01/2023 02:51 PM,0,0,0
0,1674190359806093962,1,0,,1,1,1,0,0,,01/22/2023 09:45 PM,0,0,0
0,1674190510129949568,2,0,,1,1,1,0,0,,01/22/2023 09:46 PM,0,0,0
0,1806749735787774444,4,0,,1,1,1,0,0,,05/04/2023 12:50 PM,0,0,0
0,1674190261021845958,1,0,,1,1,1,0,0,,01/22/2023 09:46 PM,0,0,0
0,1674190230957074838,1,0,,1,1,1,0,0,0.0,01/22/2023 09:46 PM,0,0,0
0,1695776995595350524,1,0,,1,1,1,0,0,,01/22/2023 09:45 PM,0,0,0
0,1674190669043739800,1,0,,1,1,1,0,0,,01/22/2023 09:44 PM,0,0,0
0,1674190660453805192,2,0,,1,1,1,0,0,,01/22/2023 09:46 PM,0,0,0
0,1806749735787774448,3,1,0.0,1,1,1,0,0,0.0,05/01/2023 02:51 PM,0,0,0
0,1674190299676551694,1,0,,1,1,1,0,0,,01/22/2023 09:44 PM,0,0,0
0,1806753669977818022,4,0,,1,1,1,0,0,,05/01/2023 03:06 PM,0,0,0
0,1674190621799099448,5,0,,1,1,1,0,0,,01/22/2023 09:46 PM,0,0,0
0,1715823816849873464,1,0,,1,1,1,0,0,0.0,01/22/2023 09:45 PM,0,0,0
0,1683527931525155814,1,0,,1,1,1,0,0,,01/22/2023 09:44 PM,0,0,0
0,1806749718607905172,2,0,,1,1,1,0,0,,05/01/2023 02:51 PM,0,0,0
0,1806749718607905182,2,0,,1,1,1,0,0,,05/01/2023 02:51 PM,0,0,0
0,1715846708743717234,1,0,,1,1,1,0,0,0.0,01/22/2023 09:47 PM,0,0,0
0,1806753669977818016,2,0,,1,1,1,0,0,,05/01/2023 03:06 PM,0,0,0
0,1715823805474202570,1,0,,1,1,1,0,0,,01/22/2023 09:44 PM,0,0,0
0,1674190256726878660,4,0,,1,1,1,0,0,0.0,01/22/2023 09:45 PM,0,0,0
1,1448642175142467180,4,0,0.0,1,1,1,1,0,0.0,01/22/2023 09:45 PM,0,1,0
0,1674190342626224744,1,0,,1,1,1,0,0,,01/22/2023 09:44 PM,0,0,0
6,1594046422462976738,3,0,0.0,1,1,1,6,0,1.0,01/22/2023 09:45 PM,0,6,0
0,1695777004185285136,0,1,,1,1,1,0,0,0.0,01/22/2023 09:44 PM,0,0,0
0,1674190647568903276,1,0,,1,1,1,0,0,0.0,01/22/2023 09:47 PM,0,0,0
0,1806749727197839824,4,0,,1,1,1,0,0,0.0,05/01/2023 02:51 PM,0,0,0
5,1582242315337619018,1,0,0.0,1,1,1,5,0,0.0,01/22/2023 09:45 PM,0,5,0
0,1683527963645655060,1,0,0.0,1,1,1,0,0,1.0,01/22/2023 09:45 PM,0,0,0
0,1674190149352696066,1,0,,1,1,1,0,0,,01/22/2023 09:46 PM,0,0,0
0,1674190613209164838,2,0,,1,1,1,0,0,0.0,01/22/2023 09:45 PM,0,0,0
3,1594046413873042136,5,0,0.0,1,1,1,3,0,0.0,01/22/2023 09:45 PM,0,3,0
0,1806753661387883390,2,0,,1,1,1,0,0,0.0,05/01/2023 03:06 PM,0,0,0
0,1674190183712434508,2,0,0.0,1,1,1,0,0,1.0,01/22/2023 09:44 PM,0,0,0
2,1806749722902872488,2,1,0.0,1,1,1,2,0,0.0,05/01/2023 02:51 PM,0,2,0
0,1674190630389034056,2,0,,1,1,1,0,0,0.0,01/22/2023 09:45 PM,0,0,0
0,1674190458590341924,2,0,,1,1,1,0,0,0.0,01/22/2023 09:47 PM,0,0,0
1,1715846696911078242,1,0,0.0,1,1,1,1,0,0.0,01/22/2023 09:45 PM,0,1,0
0,1674190407050734272,1,0,0.0,1,1,1,0,0,1.0,01/22/2023 09:47 PM,0,0,0
0,1806753635618079460,2,0,,1,1,1,0,0,0.0,05/01/2023 03:06 PM,0,0,0
0,1674190312561453616,2,0,,1,1,1,0,0,0.0,01/22/2023 09:45 PM,0,0,0
0,1674190407050734276,2,0,,1,1,1,0,0,,01/22/2023 09:45 PM,0,0,0
0,1674190475770211134,1,0,,1,1,1,0,0,0.0,01/22/2023 09:44 PM,0,0,0
0,1695776985249749774,1,0,,1,1,1,0,0,,01/22/2023 09:46 PM,0,0,0
0,1674190235252042148,4,0,,1,1,1,0,0,0.0,01/22/2023 09:44 PM,0,0,0
0,1674190471475243834,1,0,,1,1,1,0,0,0.0,01/22/2023 09:44 PM,0,0,0
0,1806753635618079456,2,0,,1,1,1,0,0,0.0,05/01/2023 03:06 PM,0,0,0
0,1715846709795980144,1,0,1.0,1,1,1,0,0,0.0,01/22/2023 09:46 PM,0,0,0
0,1715823808259938858,1,0,,1,1,1,0,0,,01/22/2023 09:44 PM,0,0,0
0,1674190376985963174,1,0,,1,1,1,0,0,,01/22/2023 09:45 PM,0,0,0
0,1575949519568499428,9,0,,1,1,1,0,0,0.0,04/26/2023 08:06 PM,0,0,0
2,1448642162257565290,1,0,0.0,1,1,1,2,0,0.0,01/22/2023 09:46 PM,0,2,0
0,1806749731492807140,2,0,,1,1,1,0,0,,05/12/2023 09:31 AM,0,0,0
0,1806749744377709078,4,0,,1,1,1,0,0,,05/01/2023 02:51 PM,0,0,0
0,1806753631323112136,2,0,,1,1,1,0,0,0.0,05/01/2023 03:06 PM,0,0,0
0,1715823792589300662,1,0,,1,1,1,0,0,,01/22/2023 09:47 PM,0,0,0
0,1695780078787721700,2,0,,1,1,1,0,0,0.0,01/22/2023 09:44 PM,0,0,0
0,1674190153647663366,3,0,,1,1,1,0,0,0.0,01/22/2023 09:46 PM,0,0,0
0,1674190192302369108,1,1,,1,1,1,0,0,,01/22/2023 09:46 PM,0,0,0
1,1593766334653391756,7,1,0.0,1,1,1,1,0,0.0,01/22/2023 09:46 PM,0,1,0
0,1571105059410550802,8,1,,1,1,1,0,0,,01/22/2023 09:44 PM,0,0,0
1,1436495105198659242,4,2,0.0,1,1,1,1,0,7.0,07/28/2022 03:40 PM,0,1,0
1,1806749731492807132,2,0,0.0,1,1,1,1,0,0.0,05/01/2023 02:51 PM,0,1,0
0,1677249819534170178,1,0,,1,1,1,0,0,,01/22/2023 09:46 PM,0,0,0
0,1674190308266486306,2,0,,1,1,1,0,0,0.0,01/22/2023 09:45 PM,0,0,0
0,1827474404723843682,5,0,,1,1,1,0,0,,06/26/2023 11:14 AM,0,0,0
0,1806753665682850718,2,0,,1,1,1,0,0,,05/01/2023 03:06 PM,0,0,0
0,1674190492950080348,2,0,,1,1,1,0,0,0.0,01/22/2023 09:46 PM,0,0,0
0,1806753639913046774,2,0,,1,1,1,0,0,,05/01/2023 03:06 PM,0,0,0
0,1677249875368745110,1,0,,1,1,1,0,0,,01/22/2023 09:47 PM,0,0,0
0,1806749722902872482,3,1,,1,1,1,0,0,,05/01/2023 02:51 PM,0,0,0
1,1674190222367140236,1,0,0.0,1,1,1,1,0,0.0,01/22/2023 09:46 PM,0,1,0
0,1806753648502981398,2,0,,1,1,1,0,0,,05/01/2023 03:06 PM,0,0,0
0,1674190677633674408,1,0,,1,1,1,0,0,,01/22/2023 09:44 PM,0,0,0
1,1715846688321143644,0,0,0.0,1,1,1,1,0,1.0,01/22/2023 09:44 PM,0,1,0
0,1674190535899753380,1,0,,1,1,1,0,0,0.0,01/22/2023 09:45 PM,0,0,0
0,1715846700153782638,2,0,,1,1,1,0,0,0.0,01/22/2023 09:46 PM,0,0,0
1,1674190183712434506,1,0,0.0,1,1,1,1,0,0.0,01/22/2023 09:46 PM,0,1,0
0,1674190157942630672,0,1,,1,1,1,0,0,,01/22/2023 09:46 PM,0,0,0
0,1436495115557663136,6,1,0.0,1,1,1,0,0,0.0,01/22/2023 09:44 PM,0,0,0
0,1806753665682850702,2,0,,1,1,1,0,0,,05/01/2023 03:06 PM,0,0,0
0,1674190291086617090,2,0,,1,1,1,0,0,0.0,01/22/2023 09:46 PM,0,0,0
0,1683527963645655062,1,0,,1,1,1,0,0,,01/22/2023 09:45 PM,0,0,0
0,1677249871073777812,1,0,,1,1,1,0,0,,01/22/2023 09:47 PM,0,0,0
0,1677249823829137478,2,0,,1,1,1,0,0,,01/22/2023 09:46 PM,0,0,0
0,1715823818359104470,1,0,,1,1,1,0,0,0.0,01/22/2023 09:45 PM,0,0,0
0,1695776937826575008,1,0,,1,1,1,0,0,0.0,01/22/2023 09:47 PM,0,0,0
2,1674190316856420914,2,0,0.0,1,1,1,2,0,0.0,01/22/2023 09:47 PM,0,2,0
0,1674190458590341922,1,0,,1,1,1,0,0,,01/22/2023 09:44 PM,0,0,0
0,1674190596029295624,1,0,,1,1,1,0,0,0.0,01/22/2023 09:45 PM,0,0,0
0,1968524019802182408,50,0,2.0,1,1,1,0,0,2.0,07/26/2024 08:13 PM,0,0,0
0,1806749727197839820,2,0,,1,1,1,0,0,,05/04/2023 12:52 PM,0,0,0
5,1806753652797948724,0,0,0.0,1,1,1,5,0,0.0,05/01/2023 03:06 PM,0,5,0
0,1806753657092916070,2,0,,1,1,1,0,0,,05/01/2023 03:06 PM,0,0,0
0,1715823801179235270,2,0,,1,1,1,0,0,,01/22/2023 09:44 PM,0,0,0
1,1448642183732401786,8,0,0.0,1,1,1,1,0,0.0,05/19/2023 02:01 PM,0,1,0
0,1674190402755766970,1,0,,1,1,1,0,0,0.0,01/22/2023 09:45 PM,0,0,0
0,1674190235252042142,2,0,,1,1,1,0,0,0.0,01/22/2023 09:47 PM,0,0,0
1,1594046392398205624,8,0,1.0,1,1,1,1,0,0.0,01/22/2023 09:44 PM,0,1,0
1,1806753635618079448,1,0,0.0,1,1,1,1,0,0.0,05/01/2023 03:06 PM,0,1,0
6,1594046452527747848,0,2,0.0,1,1,1,6,0,1.0,01/22/2023 09:47 PM,0,6,0
0,1806753661387883376,2,0,,1,1,1,0,0,,05/04/2023 12:48 PM,0,0,0
0,1674190514424916874,1,0,,1,1,1,0,0,,01/22/2023 09:46 PM,0,0,0
2,1806749731492807136,0,0,0.0,1,1,1,2,0,0.0,05/01/2023 02:51 PM,0,2,0
2,1561012870126088746,7,0,1.0,1,1,1,2,0,0.0,01/22/2023 09:46 PM,0,2,0
0,1674190505834982262,2,0,,1,1,1,0,0,,01/22/2023 09:46 PM,0,0,0
0,1563698701206292480,8,1,,1,1,1,0,0,,01/22/2023 09:44 PM,0,0,0
0,1674190230957074842,2,0,,1,1,1,0,0,,01/22/2023 09:44 PM,0,0,0
0,1674190514424916870,2,0,,1,1,1,0,0,,01/22/2023 09:47 PM,0,0,0
0,1806749748672676388,3,1,,1,1,1,0,0,,05/01/2023 02:51 PM,0,0,0
0,1674190188007401806,4,0,,1,1,1,0,0,0.0,01/22/2023 09:46 PM,0,0,0
1,1715846691563848024,1,0,0.0,1,1,1,1,0,1.0,01/22/2023 09:45 PM,0,1,0
0,1683527935820123118,1,0,,1,1,1,0,0,0.0,01/22/2023 09:47 PM,0,0,0
0,1674190402755766968,0,1,,1,1,1,0,0,0.0,01/22/2023 09:45 PM,0,0,0
0,1674190441410472712,5,0,,1,1,1,0,0,,01/22/2023 09:45 PM,0,0,0
0,1674190325446355532,2,0,,1,1,1,0,0,0.0,01/22/2023 09:45 PM,0,0,0
0,1674190265316813260,1,0,,1,1,1,0,0,,01/22/2023 09:45 PM,0,0,0
0,1806753661387883384,2,0,,1,1,1,0,0,,05/01/2023 03:06 PM,0,0,0
4,1674190346921192044,2,1,0.0,1,1,1,4,0,0.0,01/22/2023 09:46 PM,0,4,0
0,1715823812554906166,1,0,,1,1,1,0,0,,01/22/2023 09:44 PM,0,0,0
0,1806749744377709070,4,0,,1,1,1,0,0,0.0,05/01/2023 02:51 PM,0,0,0
0,1683527944410057716,1,0,,1,1,1,0,0,,01/22/2023 09:44 PM,0,0,0
3,1677249810944235574,0,0,0.0,1,1,1,3,0,0.0,01/22/2023 09:44 PM,0,3,0
0,1575949506683597522,9,0,,1,1,1,0,0,0.0,01/22/2023 09:46 PM,0,0,0
0,1806753644208014100,2,0,,1,1,1,0,0,,05/01/2023 03:06 PM,0,0,0
0,1715823782490135060,1,0,,1,1,1,0,0,,01/22/2023 09:47 PM,0,0,0
0,1677249862483843202,2,0,0.0,1,1,1,0,0,1.0,01/22/2023 09:47 PM,0,0,0
0,1683527967940622360,1,0,,1,1,1,0,0,,01/22/2023 09:46 PM,0,0,0
0,1674190454295374616,2,0,,1,1,1,0,0,,01/22/2023 09:47 PM,0,0,0
0,1695777014128478334,2,0,,1,1,1,0,0,0.0,01/22/2023 09:45 PM,0,0,0
3,1674190651863870576,2,0,0.0,1,1,1,3,0,0.0,01/22/2023 09:47 PM,0,3,0
0,1674190677633674406,2,0,,1,1,1,0,0,0.0,01/22/2023 09:44 PM,0,0,0
2,1674190484360145738,0,1,0.0,1,1,1,2,0,0.0,01/22/2023 09:47 PM,0,2,0
0,1677249888253647030,1,0,,1,1,1,0,0,,01/22/2023 09:44 PM,0,0,0
0,1677249853893908598,1,0,,1,1,1,0,0,,01/22/2023 09:44 PM,0,0,0
1,1448642188027369090,2,0,0.0,1,1,1,1,0,0.0,01/22/2023 09:44 PM,0,1,0
0,1695776946416509604,1,0,,1,1,1,0,0,0.0,01/22/2023 09:45 PM,0,0,0
0,1674190183712434504,2,0,,1,1,1,0,0,0.0,01/22/2023 09:47 PM,0,0,0
0,1674190656158837882,1,0,,1,1,1,0,0,0.0,01/22/2023 09:45 PM,0,0,0
1,1575949528657471478,7,0,0.0,1,1,1,1,0,0.0,01/22/2023 09:45 PM,0,1,0
0,1806753647178082938,2,0,,1,1,1,0,0,,05/01/2023 03:06 PM,0,0,0
1,1715846718385914740,0,1,0.0,1,1,1,1,0,0.0,01/22/2023 09:46 PM,0,1,0
0,1806753661387883388,2,0,,1,1,1,0,0,,05/09/2023 11:49 AM,0,0,0
0,1674190282496682480,2,1,,1,1,1,0,0,,01/22/2023 09:44 PM,0,0,0
0,1674190647568903272,3,0,,1,1,1,0,0,,01/22/2023 09:45 PM,0,0,0
1,1695776991300383222,1,1,0.0,1,1,1,1,0,0.0,01/22/2023 09:45 PM,0,1,0
0,1673852330577033842,2,0,,1,1,1,0,0,0.0,01/22/2023 09:45 PM,0,0,0
0,1827474409018810994,2,1,,1,1,1,0,0,,06/26/2023 11:14 AM,0,0,0
0,1683527965884893196,1,0,,1,1,1,0,0,0.0,01/22/2023 09:47 PM,0,0,0
0,1806749727197839806,2,0,,1,1,1,0,0,,05/15/2023 04:44 PM,0,0,0
0,1827474409018810988,0,1,,1,1,1,0,0,,06/26/2023 11:14 AM,0,0,0
1,1674190596029295628,1,0,0.0,1,1,1,1,0,0.0,01/22/2023 09:44 PM,0,1,0
0,1674190316856420916,1,0,,1,1,1,0,0,0.0,01/22/2023 09:44 PM,0,0,0
0,1674190303971519002,1,0,,1,1,1,0,0,,01/22/2023 09:44 PM,0,0,0
0,1674190608914197534,1,0,,1,1,1,0,0,,01/22/2023 09:46 PM,0,0,0
0,1674190437115505406,2,0,,1,1,1,0,0,0.0,01/22/2023 09:44 PM,0,0,0
0,1674190226662107534,1,0,0.0,1,1,1,0,0,2.0,01/22/2023 09:44 PM,0,0,0
0,1677249866778810502,1,0,,1,1,1,0,0,0.0,01/22/2023 09:44 PM,0,0,0
0,1695776976641823202,1,0,,1,1,1,0,0,,01/22/2023 09:45 PM,0,0,0
0,1695780078787721704,1,0,,1,1,1,0,0,0.0,01/22/2023 09:47 PM,0,0,0
0,1695776961235612130,1,0,,1,1,1,0,0,,01/22/2023 09:44 PM,0,0,0
2,1806753665682850694,0,0,0.0,1,1,1,2,2,0.0,05/12/2023 09:45 AM,0,2,0
0,1806749752967643698,4,0,,1,1,1,0,0,,05/15/2023 02:29 PM,0,0,0
0,1674190200892303714,1,0,,1,1,1,0,0,,01/22/2023 09:44 PM,0,0,0
0,1674190475770211132,1,0,,1,1,1,0,0,,01/22/2023 09:46 PM,0,0,0
0,1674190505834982258,2,0,,1,1,1,0,0,0.0,01/22/2023 09:45 PM,0,0,0
0,1674190218072172924,1,0,,1,1,1,0,0,,01/22/2023 09:44 PM,0,0,0
0,1715823796884267966,1,0,,1,1,1,0,0,,01/22/2023 09:46 PM,0,0,0
4,1561012878716023344,3,0,0.0,1,1,1,4,0,0.0,01/22/2023 09:44 PM,0,4,0
0,1674190527309818772,2,0,,1,1,1,0,0,0.0,01/22/2023 09:45 PM,0,0,0
0,1674190574554459116,0,1,,1,1,1,0,0,0.0,01/22/2023 09:44 PM,0,0,0
0,1674190424230603496,1,0,,1,1,1,0,0,,01/22/2023 09:45 PM,0,0,0
0,1715846688321143646,2,0,,1,1,1,0,0,0.0,01/22/2023 09:47 PM,0,0,0
3,1594046379513303720,3,0,0.0,1,1,1,3,0,2.0,01/22/2023 09:46 PM,0,3,0
0,1806753657092916056,2,0,,1,1,1,0,0,,05/01/2023 03:06 PM,0,0,0
0,1674190226662107538,1,0,,1,1,1,0,0,0.0,01/22/2023 09:45 PM,0,0,0
0,1806753661387883392,2,0,,1,1,1,0,0,0.0,05/01/2023 03:06 PM,0,0,0
1,1674190308266486308,0,0,0.0,1,1,1,1,0,0.0,01/22/2023 09:46 PM,0,1,0
0,1806753644208014096,2,0,,1,1,1,0,0,,05/01/2023 03:06 PM,0,0,0
0,1674190501540014960,2,0,0.0,1,1,1,0,0,1.0,01/22/2023 09:46 PM,0,0,0
0,1715846695858815334,1,0,,1,1,1,0,0,0.0,01/22/2023 09:45 PM,0,0,0
0,1674190329741322832,3,0,,1,1,1,0,0,0.0,01/22/2023 09:44 PM,0,0,0
0,1806749722902872502,5,0,,1,1,1,0,0,,05/09/2023 11:44 AM,0,0,0
0,1968523359874576876,50,0,,0,0,0,0,0,0.0,07/24/2024 04:40 PM,0,0,0
3,1575949510978564830,6,0,0.0,1,1,1,3,0,0.0,01/22/2023 09:45 PM,0,3,0
0,1683527952999991298,10,0,,1,1,1,0,0,0.0,01/22/2023 09:46 PM,0,0,0
0,1674190613209164834,2,0,,1,1,1,0,0,0.0,01/22/2023 09:44 PM,0,0,0
0,1695776953225711660,1,0,,1,1,1,0,0,,01/22/2023 09:44 PM,0,0,0
0,1571105055115583502,9,0,,1,1,1,0,0,,01/22/2023 09:44 PM,0,0,0
0,1677249815239202878,1,0,,1,1,1,0,0,,01/22/2023 09:45 PM,0,0,0
0,1674190630389034054,1,0,,1,1,1,0,0,,01/22/2023 09:45 PM,0,0,0
0,1695780091296484234,1,0,,1,1,1,0,0,0.0,01/22/2023 09:46 PM,0,0,0
0,1677249888253647024,1,0,,1,1,1,0,0,,01/22/2023 09:45 PM,0,0,0
0,1674190523014851470,1,0,,1,1,1,0,0,0.0,01/22/2023 09:45 PM,0,0,0
0,1674190510129949562,2,0,,1,1,1,0,0,,01/22/2023 09:47 PM,0,0,0
0,1674190316856420920,1,0,,1,1,1,0,0,,01/22/2023 09:47 PM,0,0,0
0,1674190166532565286,5,0,,1,1,1,0,0,,01/22/2023 09:45 PM,0,0,0
1,1594046388103238326,7,1,0.0,1,1,1,1,0,0.0,01/22/2023 09:46 PM,0,1,0
0,1674190510129949566,1,0,,1,1,1,0,0,,01/22/2023 09:44 PM,0,0,0
3,1448642175142467184,1,0,0.0,1,1,1,3,0,0.0,05/25/2023 04:45 PM,0,3,0
0,1968524076032467544,50,0,,1,1,1,0,0,0.0,07/26/2024 08:14 PM,0,0,0
0,1683527948705024000,1,0,,1,1,1,0,0,0.0,01/22/2023 09:44 PM,0,0,0
1,1677249845303973992,0,0,0.0,1,1,1,1,0,0.0,01/22/2023 09:47 PM,0,1,0
0,1674190351216159352,1,0,,1,1,1,0,0,0.0,01/22/2023 09:44 PM,0,0,0
0,1715823795375036962,1,0,,1,1,1,0,0,,01/22/2023 09:46 PM,0,0,0
0,1806749757262611018,2,0,,1,1,1,0,0,,05/01/2023 02:51 PM,0,0,0
0,1674190321151388226,2,0,,1,1,1,0,0,,01/22/2023 09:44 PM,0,0,0
0,1674190205187271018,1,2,,1,1,1,0,0,,01/22/2023 09:45 PM,0,0,0
0,1683527948705025022,1,0,,1,1,1,0,0,0.0,01/22/2023 09:45 PM,0,0,0
0,1806753644208014084,2,0,,1,1,1,0,0,,05/01/2023 03:06 PM,0,0,0
8,1594046370923369114,1,0,0.0,1,1,1,8,0,0.0,04/26/2023 08:04 PM,0,8,0
0,1695776941114034252,1,0,,1,1,1,0,0,0.0,01/22/2023 09:47 PM,0,0,0
0,1806749722902872484,8,0,,1,1,1,0,0,,05/11/2023 11:08 AM,0,0,0
1,1674190664748772494,0,0,0.0,1,1,1,1,0,0.0,01/22/2023 09:46 PM,0,1,0
0,1677249841009006694,1,0,,1,1,1,0,0,,01/22/2023 09:46 PM,0,0,0
0,1806753665682850704,2,0,,1,1,1,0,0,,05/01/2023 03:06 PM,0,0,0
0,1674190673338707100,1,0,,1,1,1,0,0,0.0,01/22/2023 09:44 PM,0,0,0
0,1806749744377709072,2,0,0.0,1,1,1,0,0,1.0,05/01/2023 02:51 PM,0,0,0
0,1806749727197839818,4,0,,1,1,1,0,0,,05/01/2023 02:51 PM,0,0,0
0,1674190312561453612,1,0,,1,1,1,0,0,0.0,01/22/2023 09:46 PM,0,0,0
0,1806753648502981412,2,0,,1,1,1,0,0,,05/01/2023 03:06 PM,0,0,0
4,1606778059648526978,4,1,0.0,1,1,1,4,0,1.0,01/22/2023 09:46 PM,0,4,0
0,1806749757262611028,4,0,,1,1,1,0,0,,05/01/2023 02:51 PM,0,0,0
0,1674190617504132144,1,0,,1,1,1,0,0,,01/22/2023 09:44 PM,0,0,0
0,1806753648502981410,2,0,,1,1,1,0,0,0.0,05/01/2023 03:06 PM,0,0,0
0,1674190608914197536,1,0,,1,1,1,0,0,,01/22/2023 09:44 PM,0,0,0
0,1674190273906747874,1,0,,1,1,1,0,0,,01/22/2023 09:46 PM,0,0,0
0,1674190329741322836,0,1,,1,1,1,0,0,0.0,01/22/2023 09:44 PM,0,0,0
0,1674190209482238318,2,0,,1,1,1,0,0,,01/22/2023 09:46 PM,0,0,0
0,1806749740082741758,9,1,,1,1,1,0,0,,05/01/2023 02:51 PM,0,0,0
0,1677249819534170176,1,0,,1,1,1,0,0,,01/22/2023 09:45 PM,0,0,0
0,1715823812554906162,1,0,,1,1,1,0,0,,01/22/2023 09:45 PM,0,0,0
0,1674190467180276530,1,0,,1,1,1,0,0,,01/22/2023 09:46 PM,0,0,0
0,1674190376985963176,1,0,,1,1,1,0,0,,01/22/2023 09:46 PM,0,0,0
0,1806753635618079452,2,0,,1,1,1,0,0,,05/12/2023 09:33 AM,0,0,0
0,1674190415640668886,2,0,,1,1,1,0,0,0.0,01/22/2023 09:44 PM,0,0,0
0,1674190544489687990,3,0,,1,1,1,0,0,,01/22/2023 09:46 PM,0,0,0
0,1674190673338707098,2,0,,1,1,1,0,0,,01/22/2023 09:44 PM,0,0,0
0,1806753652797948734,2,0,,1,1,1,0,0,,05/01/2023 03:06 PM,0,0,0
0,1674190273906747868,1,0,,1,1,1,0,0,,01/22/2023 09:45 PM,0,0,0
1,1674190209482238320,1,0,0.0,1,1,1,1,0,0.0,01/22/2023 09:44 PM,0,1,0
9,1594046456830870690,0,3,0.0,1,1,1,9,0,0.0,01/22/2023 09:46 PM,0,9,0
1,1827474409018810998,2,0,0.0,1,1,1,1,0,0.0,06/26/2023 11:14 AM,0,1,0
0,1674190531604786080,1,0,,1,1,1,0,0,0.0,01/22/2023 09:46 PM,0,0,0
0,1674190608914197532,2,0,,1,1,1,0,0,0.0,01/22/2023 09:46 PM,0,0,0
0,1674190200892303716,1,0,,1,1,1,0,0,,01/22/2023 09:45 PM,0,0,0
5,1674190527309818770,0,0,0.0,1,1,1,5,0,0.0,01/22/2023 09:45 PM,0,5,0
0,1674190424230603494,1,0,,1,1,1,0,0,,01/22/2023 09:46 PM,0,0,0
0,1677249793764366368,1,0,,1,1,1,0,0,0.0,01/22/2023 09:47 PM,0,0,0
0,1674190338331257440,1,0,,1,1,1,0,0,,01/22/2023 09:46 PM,0,0,0
2,1806753652797948750,0,0,0.0,1,1,1,2,0,0.0,05/03/2023 03:54 PM,0,2,0
0,1674190656158837886,2,0,,1,1,1,0,0,,01/22/2023 09:46 PM,0,0,0
0,1806753657092916064,0,1,0.0,1,1,1,0,0,0.0,05/09/2023 04:47 PM,0,0,0
9,1448642179437434482,0,0,0.0,1,1,1,9,0,0.0,01/22/2023 09:47 PM,0,9,0
0,1806749731492807134,2,0,,1,1,1,0,0,,05/01/2023 02:51 PM,0,0,0
0,1806753631323112134,2,0,,1,1,1,0,0,,05/01/2023 03:06 PM,0,0,0
0,1806749744377709074,2,0,,1,1,1,0,0,,05/01/2023 02:51 PM,0,0,0
0,1806749718607905154,2,0,,1,1,1,0,0,,05/01/2023 02:51 PM,0,0,0
0,1674190561669557208,2,0,0.0,1,1,1,0,0,1.0,01/22/2023 09:44 PM,0,0,0
4,1674190286791649784,0,1,0.0,1,1,1,4,0,0.0,01/22/2023 09:45 PM,0,4,0
0,1674190535899753382,1,0,,1,1,1,0,0,,01/22/2023 09:47 PM,0,0,0
0,1695776944055742932,2,0,,1,1,1,0,0,0.0,05/08/2023 09:39 AM,0,0,0
0,1806749718607905168,2,0,,1,1,1,0,0,,05/01/2023 02:51 PM,0,0,0
0,1806753644208014098,1,1,,1,1,1,0,0,,05/01/2023 03:06 PM,0,0,0
0,1674190454295374620,1,0,,1,1,1,0,0,,01/22/2023 09:46 PM,0,0,0
0,1674190557374589904,2,0,,1,1,1,0,0,0.0,01/22/2023 09:44 PM,0,0,0
0,1677249853893908602,10,0,,1,1,1,0,0,0.0,01/22/2023 09:44 PM,0,0,0
2,1674190634684001360,0,0,0.0,1,1,1,2,0,0.0,01/22/2023 09:45 PM,0,2,0
0,1806753652797948732,2,0,,1,1,1,0,0,,05/09/2023 11:47 AM,0,0,0
0,1806749735787774446,2,0,,1,1,1,0,0,,05/01/2023 02:51 PM,0,0,0
0,1674190673338707104,1,0,,1,1,1,0,0,0.0,01/22/2023 09:47 PM,0,0,0
1,1674190694813543598,1,0,0.0,1,1,1,1,0,0.0,01/22/2023 09:44 PM,0,1,0
0,1806753644208014090,2,0,,1,1,1,0,0,,05/01/2023 03:06 PM,0,0,0
0,1806753665682850696,2,0,,1,1,1,0,0,,05/01/2023 03:06 PM,0,0,0
1,1806749722902872486,1,0,0.0,1,1,1,1,0,0.0,05/01/2023 02:51 PM,0,1,0
0,1695777003591137960,2,0,,1,1,1,0,0,0.0,01/22/2023 09:45 PM,0,0,0
3,1594046435347878642,5,1,0.0,1,1,1,3,0,0.0,01/22/2023 09:45 PM,0,3,0
0,1674190643273935970,1,0,,1,1,1,0,0,,01/22/2023 09:46 PM,0,0,0
0,1806753665682850712,2,0,,1,1,1,0,0,,05/01/2023 03:06 PM,0,0,0
0,1695777002429618978,1,0,,1,1,1,0,0,,01/22/2023 09:45 PM,0,0,0
1,1806749757262611038,3,0,0.0,1,1,1,1,0,0.0,05/01/2023 02:51 PM,0,1,0
0,1677249823829137480,2,0,,1,1,1,0,0,,01/22/2023 09:45 PM,0,0,0
0,1674190501540014954,0,1,,1,1,1,0,0,,01/22/2023 09:45 PM,0,0,0
0,1674190531604786076,2,0,,1,1,1,0,0,0.0,01/22/2023 09:46 PM,0,0,0
0,1674190548784655294,3,0,,1,1,1,0,0,0.0,01/22/2023 09:47 PM,0,0,0
0,1806749727197839828,4,0,,1,1,1,0,0,,05/01/2023 02:51 PM,0,0,0
0,1806753661387883380,1,1,,1,1,1,0,0,,05/01/2023 03:06 PM,0,0,0
0,1674190475770211138,1,0,,1,1,1,0,0,0.0,01/22/2023 09:47 PM,0,0,0
0,1674190166532565282,2,0,,1,1,1,0,0,,01/22/2023 09:46 PM,0,0,0
0,1677249883958679720,1,0,,1,1,1,0,0,,01/22/2023 09:44 PM,0,0,0
5,1594046409578074834,4,0,0.0,1,1,1,5,0,1.0,01/22/2023 09:44 PM,0,5,0
0,1674190432820538104,1,0,,1,1,1,0,0,,05/11/2023 11:05 AM,0,0,0
0,1715846692616110944,1,0,,1,1,1,0,0,0.0,01/22/2023 09:47 PM,0,0,0
0,1806749744377709062,2,0,,1,1,1,0,0,,05/01/2023 02:51 PM,0,0,0
3,1674190355511126654,0,0,0.0,1,1,1,3,0,0.0,01/22/2023 09:44 PM,0,3,0
0,1677249836714039386,1,0,,1,1,1,0,0,,01/22/2023 09:45 PM,0,0,0
0,1674190690518576300,1,0,,1,1,1,0,0,,01/22/2023 09:46 PM,0,0,0
6,1594046422462976736,2,0,0.0,1,1,1,6,0,2.0,01/22/2023 09:44 PM,0,6,0
0,1674190230957074840,3,0,,1,1,1,0,0,0.0,01/22/2023 09:44 PM,0,0,0
0,1806753635618079450,2,0,,1,1,1,0,0,,05/01/2023 03:06 PM,0,0,0
0,1674190239547009450,1,0,,1,1,1,0,0,,01/22/2023 09:45 PM,0,0,0
0,1806753661387883374,2,0,,1,1,1,0,0,,05/01/2023 03:06 PM,0,0,0
0,1695776989544717076,1,0,,1,1,1,0,0,,01/22/2023 09:44 PM,0,0,0
1,1448642188027369086,4,0,0.0,1,1,1,1,0,0.0,01/22/2023 09:45 PM,0,1,0
0,1806749718607905180,2,0,,1,1,1,0,0,,05/01/2023 02:51 PM,0,0,0
1,1806749722902872500,8,0,0.0,1,1,1,1,0,0.0,05/11/2023 11:13 AM,0,1,0
0,1674190248136944056,1,0,,1,1,1,0,0,0.0,01/22/2023 09:47 PM,0,0,0
0,1683527948705025018,1,0,,1,1,1,0,0,0.0,01/22/2023 09:44 PM,0,0,0
0,1674190600324262930,0,1,0.0,1,1,1,0,0,0.0,01/22/2023 09:44 PM,0,0,0
0,1674190621799099444,1,0,,1,1,1,0,0,0.0,01/22/2023 09:44 PM,0,0,0
0,1674190677633674404,2,0,,1,1,1,0,0,0.0,01/22/2023 09:45 PM,0,0,0
0,1674190651863870582,1,0,,1,1,1,0,0,,01/22/2023 09:45 PM,0,0,0
1,1715823825439808068,0,0,0.0,1,1,1,1,0,0.0,01/22/2023 09:45 PM,0,1,0
2,1594046383808271024,7,0,0.0,1,1,1,2,0,0.0,01/22/2023 09:45 PM,0,2,0
0,1674190445705440012,0,1,,1,1,1,0,0,0.0,01/22/2023 09:45 PM,0,0,0
1,1674190544489687994,0,1,0.0,1,1,1,1,0,0.0,01/22/2023 09:46 PM,0,1,0
0,1806749722902872504,2,0,,1,1,1,0,0,,05/01/2023 02:51 PM,0,0,0
0,1806753639913046766,2,0,,1,1,1,0,0,,05/09/2023 11:45 AM,0,0,0
0,1674190591734328322,1,0,,1,1,1,0,0,,01/22/2023 09:44 PM,0,0,0
0,1695776957520678960,1,0,,1,1,1,0,0,,01/22/2023 09:45 PM,0,0,0
3,1594046461117682452,4,0,0.0,1,1,1,3,0,0.0,05/13/2024 03:11 PM,0,3,0
0,1806753648502981420,2,0,,1,1,1,0,0,,05/01/2023 03:06 PM,0,0,0
0,1674190441410472710,2,0,,1,1,1,0,0,0.0,05/08/2023 09:39 AM,0,0,0
0,1674190269611780570,1,0,,1,1,1,0,0,,01/22/2023 09:46 PM,0,0,0
0,1695776942300076784,1,0,,1,1,1,0,0,0.0,01/22/2023 09:46 PM,0,0,0
1,1674190205187271016,1,0,0.0,1,1,1,1,0,0.0,01/22/2023 09:44 PM,0,1,0
0,1436495109493626546,4,1,1.0,1,1,1,0,0,1.0,07/28/2022 03:42 PM,0,0,0
0,1674190166532565278,1,0,,1,1,1,0,0,,01/22/2023 09:45 PM,0,0,0
0,1436495105198659246,5,1,0.0,1,1,1,0,0,0.0,07/28/2022 03:42 PM,0,0,0
0,1674190565964524510,2,0,,1,1,1,0,0,,01/22/2023 09:46 PM,0,0,0
0,1806753661387883378,2,0,,1,1,1,0,0,,05/01/2023 03:06 PM,0,0,0
0,1806753657092916074,2,0,,1,1,1,0,0,,05/01/2023 03:06 PM,0,0,0
0,1594046362333434512,8,1,,1,1,1,0,0,0.0,05/16/2023 09:36 AM,0,0,0
1,1594046439642845944,3,2,0.0,1,1,1,1,0,0.0,01/22/2023 09:47 PM,0,1,0
3,1674190213777205620,0,0,0.0,1,1,1,3,0,0.0,01/22/2023 09:44 PM,0,3,0
0,1806749757262611022,2,0,,1,1,1,0,0,,05/01/2023 02:51 PM,0,0,0
0,1827484051430132398,2,0,,1,1,1,0,0,,06/26/2023 11:51 AM,0,0,0
0,1674190492950080350,1,0,,1,1,1,0,0,,01/22/2023 09:45 PM,0,0,0
0,1674190570259491814,2,0,,1,1,1,0,0,0.0,01/22/2023 09:44 PM,0,0,0
0,1677249862483843204,2,0,,1,1,1,0,0,0.0,01/22/2023 09:44 PM,0,0,0
0,1806753631323112124,2,0,,1,1,1,0,0,,05/01/2023 03:06 PM,0,0,0
0,1674190638978968662,2,0,,1,1,1,0,0,,01/22/2023 09:44 PM,0,0,0
0,1806749731492807146,2,0,,1,1,1,0,0,,05/04/2023 12:48 PM,0,0,0
0,1806749748672676380,4,0,,1,1,1,0,0,,05/01/2023 02:51 PM,0,0,0
0,1683527942170819574,1,0,,1,1,1,0,0,0.0,01/22/2023 09:44 PM,0,0,0
3,1683527950760754170,0,0,0.0,1,1,1,3,0,0.0,01/22/2023 09:44 PM,0,3,0
0,1695776940340809768,1,0,,1,1,1,0,0,0.0,01/22/2023 09:46 PM,0,0,0
2,1674190583144393718,0,1,0.0,1,1,1,2,0,0.0,01/22/2023 09:46 PM,0,2,0
0,1806753652797948726,2,0,,1,1,1,0,0,,05/01/2023 03:06 PM,0,0,0
0,1827474404723843690,2,0,,1,1,1,0,0,,06/26/2023 11:14 AM,0,0,0
0,1806749748672676394,4,0,,1,1,1,0,0,,05/01/2023 02:51 PM,0,0,0
0,1806749757262611030,3,0,,1,1,1,0,0,,05/01/2023 02:51 PM,0,0,0
0,1674190157942630668,1,0,,1,1,1,0,0,,01/22/2023 09:45 PM,0,0,0
0,1674190450000407312,1,0,,1,1,1,0,0,,01/22/2023 09:46 PM,0,0,0
0,1715823779704398766,2,0,,1,1,1,0,0,,01/22/2023 09:45 PM,0,0,0
0,1674190372690995870,1,0,,1,1,1,0,0,0.0,01/22/2023 09:46 PM,0,0,0
0,1806753648502981404,2,0,,1,1,1,0,0,,05/01/2023 03:06 PM,0,0,0
0,1806753648502981424,2,0,,1,1,1,0,0,,05/01/2023 03:06 PM,0,0,0
0,1806749727197839816,6,0,,1,1,1,0,0,,05/04/2023 12:51 PM,0,0,0
0,1674190192302369106,1,0,,1,1,1,0,0,,01/22/2023 09:46 PM,0,0,0
0,1674190565964524512,1,0,,1,1,1,0,0,0.0,01/22/2023 09:44 PM,0,0,0
2,1594041785694887804,5,0,0.0,1,1,1,2,0,0.0,01/22/2023 09:46 PM,0,2,0
0,1677249780879464468,1,0,,1,1,1,0,0,,01/22/2023 09:46 PM,0,0,0
0,1677249802354300978,1,0,,1,1,1,0,0,,01/22/2023 09:47 PM,0,0,0
0,1806749752967643694,7,0,,1,1,1,0,0,,05/01/2023 02:51 PM,0,0,0
0,1695777017650221152,1,0,,1,1,1,0,0,0.0,01/22/2023 09:46 PM,0,0,0
0,1674190480065178440,1,0,,1,1,1,0,0,0.0,01/22/2023 09:44 PM,0,0,0
0,1695776998116659702,1,0,,1,1,1,0,0,,01/22/2023 09:46 PM,0,0,0
1,1683527955055720452,0,0,0.0,1,1,1,1,0,0.0,01/22/2023 09:44 PM,0,1,0
2,1677249862483843200,2,0,0.0,1,1,1,2,0,0.0,01/22/2023 09:46 PM,0,2,0
0,1674190587439361020,2,0,,1,1,1,0,0,0.0,01/22/2023 09:46 PM,0,0,0
0,1677249836714039384,1,0,,1,1,1,0,0,,01/22/2023 09:46 PM,0,0,0
0,1695776968069880576,1,0,,1,1,1,0,0,,01/22/2023 09:46 PM,0,0,0
8,1571105050820616196,0,3,0.0,1,1,1,8,0,0.0,01/22/2023 09:46 PM,0,8,0
0,1677249828124104788,1,0,,1,1,1,0,0,0.0,01/22/2023 09:46 PM,0,0,0
0,1674190222367140226,2,0,,1,1,1,0,0,0.0,01/22/2023 09:45 PM,0,0,0
